"datazone","stayer","total","mover","one_year_mover_prop","ten_year_stayer_prop"
"S01000001",793,937,144,0.153681963713981,0.188510681854642
"S01000002",620,752,132,0.175531914893617,0.145123749007147
"S01000003",770,876,106,0.121004566210046,0.275338023192751
"S01000004",591,687,96,0.139737991266376,0.221976724286574
"S01000005",588,726,138,0.190082644628099,0.121452666375635
"S01000006",562,664,102,0.153614457831325,0.188661099878366
"S01000007",802,893,91,0.101903695408735,0.341372941203768
"S01000008",538,634,96,0.151419558359621,0.193611066760476
"S01000009",666,759,93,0.122529644268775,0.270597969071559
"S01000010",529,613,84,0.137030995106036,0.229061433973562
"S01000011",803,947,144,0.152059134107709,0.192156757953272
"S01000012",813,950,137,0.144210526315789,0.210702361476516
"S01000013",847,947,100,0.105596620908131,0.327592773768493
"S01000014",864,1000,136,0.136,0.231812806445088
"S01000015",608,721,113,0.156726768377254,0.181837371749099
"S01000016",478,597,119,0.199329983249581,0.108276860491232
"S01000017",896,991,95,0.0958627648839556,0.365042602310959
"S01000018",538,623,85,0.136436597110754,0.230644068386015
"S01000019",559,622,63,0.101286173633441,0.343727462481544
"S01000020",733,888,155,0.17454954954955,0.146862219938364
"S01000021",761,944,183,0.19385593220339,0.115911526341135
"S01000022",659,745,86,0.115436241610738,0.293286058089506
"S01000023",707,823,116,0.140947752126367,0.218874811892592
"S01000024",428,549,121,0.22040072859745,0.0829304927086368
"S01000025",758,914,156,0.170678336980306,0.153896980514625
"S01000026",869,994,125,0.125754527162978,0.260815814092086
"S01000027",752,857,105,0.122520420070012,0.270626416386213
"S01000028",918,1047,129,0.123209169054441,0.268509709815609
"S01000029",625,744,119,0.15994623655914,0.175013204964229
"S01000030",466,546,80,0.146520146520147,0.205084453539805
"S01000031",794,909,115,0.126512651265127,0.258562889255038
"S01000032",1026,1159,133,0.114754098360656,0.295555637853674
"S01000033",733,845,112,0.132544378698225,0.241252963547151
"S01000034",927,1076,149,0.138475836431227,0.225255097675779
"S01000035",928,1096,168,0.153284671532847,0.189397490658401
"S01000036",657,791,134,0.169405815423515,0.156274767202592
"S01000037",712,898,186,0.207126948775056,0.0981830614424901
"S01000038",816,894,78,0.087248322147651,0.40135289467125
"S01000039",862,1019,157,0.154072620215898,0.187642330490431
"S01000040",918,1034,116,0.112185686653772,0.30424358119461
"S01000041",798,875,77,0.088,0.398059857579335
"S01000042",725,863,138,0.159907300115875,0.175094340404697
"S01000043",709,932,223,0.239270386266094,0.0649087474050079
"S01000044",874,1017,143,0.140609636184857,0.219737812670399
"S01000045",541,619,78,0.126009693053312,0.260055570429976
"S01000046",706,821,115,0.140073081607795,0.221113591772341
"S01000047",646,864,218,0.252314814814815,0.0545993855359716
"S01000048",832,1014,182,0.179487179487179,0.138310041914343
"S01000049",708,811,103,0.127003699136868,0.257112999431469
"S01000050",587,694,107,0.154178674351585,0.187407215486929
"S01000051",757,814,57,0.07002457002457,0.483854457248796
"S01000052",627,733,106,0.144611186903138,0.209717978044804
"S01000053",889,1164,275,0.236254295532646,0.0675286094109369
"S01000054",717,806,89,0.110421836228288,0.310342417327345
"S01000055",682,843,161,0.190984578884935,0.120106911751181
"S01000056",930,1080,150,0.138888888888889,0.22417745303365
"S01000057",646,765,119,0.155555555555556,0.184378733898665
"S01000058",647,747,100,0.133868808567604,0.237594721816083
"S01000059",704,905,201,0.222099447513812,0.0811410828842207
"S01000060",524,675,151,0.223703703703704,0.0794831630318213
"S01000061",879,1017,138,0.135693215339233,0.232637231833843
"S01000062",821,1128,307,0.272163120567376,0.0417196421604922
"S01000063",822,1080,258,0.238888888888889,0.0652349930618387
"S01000064",592,688,96,0.13953488372093,0.222501367685551
"S01000065",778,1097,319,0.290793072014585,0.0321906461467956
"S01000066",693,927,234,0.252427184466019,0.0545173835604406
"S01000067",793,981,188,0.191641182466871,0.119135666656351
"S01000068",723,940,217,0.230851063829787,0.072461018973187
"S01000069",635,746,111,0.148793565683646,0.199686625630176
"S01000070",593,713,120,0.168302945301543,0.158362239634569
"S01000071",675,841,166,0.197384066587396,0.110937345609301
"S01000072",761,868,107,0.123271889400922,0.268317695924747
"S01000073",569,657,88,0.133942161339422,0.237393579182155
"S01000074",685,864,179,0.207175925925926,0.0981224289095709
"S01000075",439,622,183,0.294212218649518,0.0306719477361456
"S01000076",714,801,87,0.108614232209738,0.316706485496445
"S01000077",784,1019,235,0.230618253189401,0.0726806473440916
"S01000078",655,945,290,0.306878306878307,0.0255914512558215
"S01000079",708,1074,366,0.340782122905028,0.015498503412499
"S01000080",735,1075,340,0.316279069767442,0.0223248602175918
"S01000081",820,1030,210,0.203883495145631,0.102274243731623
"S01000082",839,1028,189,0.183852140077821,0.131125893854194
"S01000083",621,830,209,0.251807228915663,0.0549711823370446
"S01000084",634,894,260,0.29082774049217,0.0321749137111758
"S01000085",440,731,291,0.398084815321477,0.00624242014292771
"S01000086",587,849,262,0.308598351001178,0.0249634215178736
"S01000087",549,970,421,0.434020618556701,0.00337292047579623
"S01000088",456,719,263,0.365785813630042,0.0105283308195148
"S01000089",882,1035,153,0.147826086956522,0.201967901650666
"S01000090",650,936,286,0.305555555555556,0.0260840533045888
"S01000091",710,1137,427,0.375549692172383,0.00901527212346061
"S01000092",576,1026,450,0.43859649122807,0.00310993438728911
"S01000093",410,688,278,0.40406976744186,0.00564877380890375
"S01000094",388,706,318,0.45042492917847,0.00251344997212555
"S01000095",556,850,294,0.345882352941176,0.014340313927157
"S01000096",661,737,76,0.103120759837178,0.336774900321688
"S01000097",843,1121,278,0.247992863514719,0.0578388461282989
"S01000098",693,1268,575,0.453470031545741,0.00237760557635386
"S01000099",692,807,115,0.142503097893432,0.214944133990734
"S01000100",509,946,437,0.461945031712474,0.0020336043366882
"S01000101",712,1026,314,0.306042884990253,0.0259015842760639
"S01000102",617,860,243,0.282558139534884,0.0361299306449522
"S01000103",428,715,287,0.401398601398601,0.00590714011295453
"S01000104",745,901,156,0.173140954495006,0.149387692037957
"S01000105",776,955,179,0.187434554973822,0.125482596544921
"S01000106",581,770,189,0.245454545454545,0.0598210555823944
"S01000107",634,1114,480,0.430879712746858,0.00356484515621836
"S01000108",559,807,248,0.30731102850062,0.025432129810985
"S01000109",667,1114,447,0.401256732495512,0.00592115501213014
"S01000110",771,876,105,0.11986301369863,0.27893481185378
"S01000111",613,832,219,0.263221153846154,0.0471380358408248
"S01000112",805,1083,278,0.256694367497692,0.0514842318520609
"S01000113",469,612,143,0.233660130718954,0.0698576875984285
"S01000114",671,1012,341,0.33695652173913,0.0164217742144601
"S01000115",808,935,127,0.135828877005348,0.232272342041014
"S01000116",665,1101,436,0.396003633060854,0.00646164751340457
"S01000117",927,1176,249,0.211734693877551,0.0926241262205074
"S01000118",647,779,132,0.169448010269576,0.156195396522393
"S01000119",605,928,323,0.348060344827586,0.0138699209010276
"S01000120",438,665,227,0.341353383458647,0.0153647200615553
"S01000121",736,839,103,0.122765196662694,0.269872439644294
"S01000122",693,821,128,0.155907429963459,0.183611878968373
"S01000123",585,683,98,0.143484626647145,0.212496423066125
"S01000124",672,1177,505,0.429056924384027,0.00368068034558471
"S01000125",666,1218,552,0.45320197044335,0.0023892929890234
"S01000126",674,1046,372,0.355640535372849,0.0123390612502093
"S01000127",749,865,116,0.134104046242775,0.236950212407274
"S01000128",796,2029,1233,0.607688516510596,8.63595174651376e-05
"S01000129",263,792,529,0.667929292929293,1.63044318190707e-05
"S01000130",667,992,325,0.327620967741935,0.0188860709821968
"S01000131",550,735,185,0.251700680272109,0.0550495158896897
"S01000132",599,948,349,0.368143459915612,0.0101434303278564
"S01000133",665,782,117,0.149616368286445,0.197764767224074
"S01000134",717,839,122,0.145411203814064,0.207764789536469
"S01000135",642,803,161,0.200498132004981,0.106707471193512
"S01000136",663,775,112,0.144516129032258,0.209951150566333
"S01000137",584,954,370,0.387840670859539,0.00739000486130198
"S01000138",587,1007,420,0.41708043694141,0.00452987592763804
"S01000139",768,864,96,0.111111111111111,0.307946147657439
"S01000140",892,1003,111,0.110667996011964,0.309484721302465
"S01000141",719,1116,397,0.35573476702509,0.0123210283769899
"S01000142",707,847,140,0.165289256198347,0.164195040316862
"S01000143",592,672,80,0.119047619047619,0.2815297772404
"S01000144",337,682,345,0.505865102639296,0.000867871170926445
"S01000145",853,967,114,0.11789038262668,0.285249945980444
"S01000146",786,1342,556,0.414307004470939,0.00475007319764304
"S01000147",561,920,359,0.390217391304348,0.00710804779069798
"S01000148",646,757,111,0.14663143989432,0.204817181242802
"S01000149",740,1205,465,0.385892116182573,0.00762863310434006
"S01000150",584,701,117,0.166904422253923,0.161045387777851
"S01000151",847,951,104,0.109358569926393,0.314071793046265
"S01000152",912,1250,338,0.2704,0.0427413517538415
"S01000153",464,689,225,0.32656023222061,0.0191861389975546
"S01000154",534,583,49,0.0840480274442539,0.415649270577313
"S01000155",745,816,71,0.0870098039215686,0.402402935257601
"S01000156",729,1160,431,0.371551724137931,0.00960938051210983
"S01000157",663,826,163,0.197336561743341,0.111003024160565
"S01000158",868,987,119,0.120567375886525,0.276710554772815
"S01000159",857,1098,241,0.219489981785064,0.0839044158396536
"S01000160",771,852,81,0.0950704225352113,0.36825430522838
"S01000161",707,1172,465,0.396757679180887,0.00638143016850617
"S01000162",807,962,155,0.161122661122661,0.172577680185636
"S01000163",960,1090,130,0.119266055045872,0.280832490219758
"S01000164",473,607,134,0.220757825370675,0.0825514102087708
"S01000165",780,936,156,0.166666666666667,0.161505582889846
"S01000166",790,1426,636,0.446002805049088,0.00272317566682843
"S01000167",675,744,69,0.092741935483871,0.3778403830501
"S01000168",910,1019,109,0.106967615309127,0.322605734644295
"S01000169",714,818,104,0.127139364303178,0.256713720589795
"S01000170",688,1231,543,0.44110479285134,0.00297374587789769
"S01000171",730,951,221,0.232386961093586,0.0710269935017331
"S01000172",481,520,39,0.075,0.458582341424737
"S01000173",732,878,146,0.16628701594533,0.162242881706719
"S01000174",697,914,217,0.237417943107221,0.0665067650156182
"S01000175",387,635,248,0.390551181102362,0.00706923464637219
"S01000176",438,939,501,0.533546325878594,0.000487624123162917
"S01000177",477,636,159,0.25,0.0563135147094727
"S01000178",723,795,72,0.0905660377358491,0.38700064280625
"S01000179",706,843,137,0.162514827995255,0.169734945108497
"S01000180",657,736,79,0.107336956521739,0.321273979100921
"S01000181",621,730,109,0.149315068493151,0.198466586680446
"S01000182",817,940,123,0.130851063829787,0.246003921027538
"S01000183",759,1354,595,0.43943870014771,0.00306359333104922
"S01000184",668,871,203,0.233065442020666,0.0704016883994798
"S01000185",661,870,209,0.240229885057471,0.0640946925529569
"S01000186",897,1029,132,0.128279883381924,0.253379037932078
"S01000187",676,772,96,0.124352331606218,0.265029340616282
"S01000188",600,1358,758,0.558173784977909,0.000283475026386257
"S01000189",577,683,106,0.155197657393851,0.185161672408253
"S01000190",827,956,129,0.134937238493724,0.234680050373452
"S01000191",802,1177,375,0.318606627017842,0.0215764034578642
"S01000192",629,911,282,0.309549945115258,0.0246219635880663
"S01000193",741,843,102,0.120996441281139,0.275363474916768
"S01000194",617,856,239,0.279205607476636,0.0378541931316713
"S01000195",632,776,144,0.185567010309278,0.128396613798018
"S01000196",863,1037,174,0.167791706846673,0.159338378495723
"S01000197",579,636,57,0.089622641509434,0.39103396425334
"S01000198",698,835,137,0.164071856287425,0.166605552598065
"S01000199",629,826,197,0.238498789346247,0.0655701204194965
"S01000200",793,898,105,0.116926503340757,0.288382237096375
"S01000201",610,713,103,0.144460028050491,0.210088873117493
"S01000202",755,995,240,0.241206030150754,0.0632759550455896
"S01000203",527,690,163,0.236231884057971,0.0675484277296658
"S01000204",594,703,109,0.155049786628734,0.185486027266572
"S01000205",609,1302,693,0.532258064516129,0.000501260039515146
"S01000206",645,788,143,0.181472081218274,0.135000373940075
"S01000207",801,953,152,0.159496327387198,0.175952788716308
"S01000208",742,952,210,0.220588235294118,0.0827312467124542
"S01000209",875,1101,226,0.205267938237965,0.100509552761129
"S01000210",498,678,180,0.265486725663717,0.045708449427959
"S01000211",618,840,222,0.264285714285714,0.0464613570162122
"S01000212",729,850,121,0.142352941176471,0.215320820485387
"S01000213",588,746,158,0.211796246648794,0.0925518248181298
"S01000214",481,528,47,0.0890151515151515,0.393651162586629
"S01000215",554,854,300,0.351288056206089,0.0131983287083083
"S01000216",585,676,91,0.134615384615385,0.235554660573633
"S01000217",621,790,169,0.213924050632911,0.0900834662833734
"S01000218",681,752,71,0.0944148936170213,0.370930643719483
"S01000219",639,783,144,0.183908045977011,0.131036100667282
"S01000220",671,1959,1288,0.657478305257785,2.22269996028714e-05
"S01000221",798,953,155,0.162644281217209,0.169472761863727
"S01000222",730,811,81,0.0998766954377312,0.349156441863076
"S01000223",483,585,102,0.174358974358974,0.147201639360002
"S01000224",703,809,106,0.131025957972806,0.245509348638605
"S01000225",550,642,92,0.143302180685358,0.212949494878614
"S01000226",566,661,95,0.143721633888048,0.211909153689228
"S01000227",585,710,125,0.176056338028169,0.144203291560645
"S01000228",574,747,173,0.231593038821954,0.0717650357982772
"S01000229",741,857,116,0.135355892648775,0.233546767460812
"S01000230",623,728,105,0.144230769230769,0.210652527070465
"S01000231",702,820,118,0.14390243902439,0.211462127584383
"S01000232",634,711,77,0.108298171589311,0.317831232128101
"S01000233",524,618,94,0.15210355987055,0.19205610590886
"S01000234",703,808,105,0.129950495049505,0.248564808885396
"S01000235",799,983,184,0.187182095625636,0.125873009193672
"S01000236",652,737,85,0.115332428765265,0.293630441913022
"S01000237",857,956,99,0.103556485355649,0.335142339108859
"S01000238",459,576,117,0.203125,0.103252843625471
"S01000239",685,771,86,0.111543450064851,0.30645162910459
"S01000240",683,760,77,0.101315789473684,0.343614208764069
"S01000241",690,779,89,0.114249037227214,0.297246213242469
"S01000242",561,711,150,0.210970464135021,0.0935260527179453
"S01000243",704,801,97,0.121098626716604,0.275043528302979
"S01000244",967,1136,169,0.148767605633803,0.19974753431275
"S01000245",886,1034,148,0.143133462282398,0.2133692503114
"S01000246",719,788,69,0.0875634517766497,0.399969365375493
"S01000247",735,814,79,0.097051597051597,0.360271030641859
"S01000248",794,933,139,0.14898177920686,0.199245529938106
"S01000249",684,774,90,0.116279069767442,0.290503527568264
"S01000250",741,878,137,0.156036446469248,0.183331427782699
"S01000251",470,536,66,0.123134328358209,0.268738991116432
"S01000252",809,946,137,0.144820295983087,0.209205863300754
"S01000253",713,767,54,0.0704041720990874,0.481883059491797
"S01000254",726,867,141,0.162629757785467,0.169502158190147
"S01000255",593,695,102,0.146762589928058,0.204502625352803
"S01000256",842,992,150,0.151209677419355,0.194090461846252
"S01000257",779,877,98,0.111744583808438,0.305758573166898
"S01000258",622,748,126,0.168449197860963,0.158083982501052
"S01000259",583,666,83,0.124624624624625,0.26420635276404
"S01000260",770,1005,235,0.233830845771144,0.0697022237973299
"S01000261",908,1063,155,0.145813734713076,0.206788241467369
"S01000262",886,1024,138,0.134765625,0.235146030853725
"S01000263",739,929,190,0.204520990312164,0.101458221237868
"S01000264",977,1078,101,0.0936920222634508,0.373902207040055
"S01000265",732,824,92,0.111650485436893,0.30608263652589
"S01000266",910,1045,135,0.129186602870813,0.25075581828493
"S01000267",643,747,104,0.139223560910308,0.223307706480377
"S01000268",717,831,114,0.137184115523466,0.228655324479015
"S01000269",587,683,96,0.140556368960469,0.219874049811686
"S01000270",885,1030,145,0.140776699029126,0.219311022602193
"S01000271",825,1001,176,0.175824175824176,0.144610128059448
"S01000272",854,1011,157,0.155291790306627,0.184955457656265
"S01000273",365,558,193,0.345878136200717,0.0143412383959648
"S01000274",563,632,69,0.109177215189873,0.314711900555188
"S01000275",933,1024,91,0.0888671875,0.394291006347264
"S01000276",683,809,126,0.1557478368356,0.183959330650505
"S01000277",596,728,132,0.181318681318681,0.13525359092735
"S01000278",500,571,71,0.124343257443082,0.265056806362038
"S01000279",540,671,131,0.195230998509687,0.113949492827549
"S01000280",548,701,153,0.218259629101284,0.0852364601318248
"S01000281",605,739,134,0.181326116373478,0.135241308043393
"S01000282",599,735,136,0.185034013605442,0.129239370221731
"S01000283",772,986,214,0.217038539553753,0.0865772633524564
"S01000284",756,875,119,0.136,0.231812806445088
"S01000285",633,717,84,0.117154811715481,0.287637525211717
"S01000286",785,1016,231,0.227362204724409,0.075815759152212
"S01000287",627,765,138,0.180392156862745,0.1367921125935
"S01000288",838,971,133,0.13697219361483,0.229217561071183
"S01000289",786,933,147,0.157556270096463,0.18005659079792
"S01000290",698,885,187,0.211299435028249,0.0931368443745416
"S01000291",746,892,146,0.163677130044843,0.167393939755
"S01000292",878,1051,173,0.164605137963844,0.165545735912468
"S01000293",663,857,194,0.226371061843641,0.076793960279178
"S01000294",635,785,150,0.191082802547771,0.119961167960737
"S01000295",574,655,81,0.123664122137405,0.267119703547686
"S01000296",504,566,62,0.109540636042403,0.313430353552179
"S01000297",732,893,161,0.180291153415454,0.136960780323171
"S01000298",287,547,260,0.475319926873857,0.00158105036218355
"S01000299",846,1040,194,0.186538461538462,0.126873300380453
"S01000300",695,833,138,0.165666266506603,0.163454932961344
"S01000301",524,611,87,0.142389525368249,0.215228989863523
"S01000302",519,622,103,0.165594855305466,0.163594889065419
"S01000303",556,660,104,0.157575757575758,0.180014944291079
"S01000304",854,952,98,0.102941176470588,0.33744983726976
"S01000305",961,1113,152,0.136567834681042,0.230293793292054
"S01000306",671,795,124,0.155974842767296,0.183465291443227
"S01000307",914,1071,157,0.146591970121382,0.204911932453318
"S01000308",915,1062,147,0.138418079096045,0.225406156234302
"S01000309",689,860,171,0.198837209302326,0.108945101200904
"S01000310",827,980,153,0.156122448979592,0.183144693003085
"S01000311",856,1039,183,0.176130895091434,0.144072857921006
"S01000312",571,682,111,0.162756598240469,0.169245580147315
"S01000313",669,746,77,0.103217158176944,0.336413103078248
"S01000314",539,614,75,0.12214983713355,0.271771518179777
"S01000315",614,695,81,0.116546762589928,0.289624745724741
"S01000316",721,835,114,0.136526946107784,0.230402874143035
"S01000317",482,583,101,0.173241852487136,0.149205500838865
"S01000318",536,615,79,0.128455284552846,0.252869668474366
"S01000319",668,805,137,0.170186335403727,0.15481242768917
"S01000320",671,785,114,0.145222929936306,0.208222968786165
"S01000321",540,634,94,0.148264984227129,0.200930108802945
"S01000322",928,1160,232,0.2,0.1073741824
"S01000323",787,943,156,0.16542948038176,0.163919415280527
"S01000324",816,952,136,0.142857142857143,0.214058315601308
"S01000325",549,652,103,0.157975460122699,0.179162654001268
"S01000326",707,817,110,0.134638922888617,0.235490598060099
"S01000327",836,971,135,0.13903192584964,0.223805355830407
"S01000328",572,636,64,0.10062893081761,0.34624948127542
"S01000329",548,657,109,0.165905631659056,0.162986595889102
"S01000330",649,785,136,0.173248407643312,0.149193671134285
"S01000331",588,658,70,0.106382978723404,0.324723952575836
"S01000332",597,753,156,0.207171314741036,0.0981281360080137
"S01000333",733,893,160,0.179171332586786,0.138843373587812
"S01000334",796,937,141,0.150480256136606,0.195764873683486
"S01000335",602,698,96,0.137535816618911,0.227724987205442
"S01000336",699,914,215,0.235229759299781,0.0684399683639422
"S01000337",615,750,135,0.18,0.137448031335961
"S01000338",455,582,127,0.218213058419244,0.0852872517314954
"S01000339",985,1164,179,0.153780068728522,0.188292274609821
"S01000340",901,1059,158,0.149197355996223,0.19874138348329
"S01000341",678,823,145,0.176184690157959,0.143978812252578
"S01000342",462,565,103,0.182300884955752,0.133639633940036
"S01000343",598,694,96,0.138328530259366,0.225640542563006
"S01000344",834,967,133,0.137538779731127,0.227717163526821
"S01000345",591,722,131,0.181440443213296,0.135052563796821
"S01000346",643,735,92,0.125170068027211,0.262564700361834
"S01000347",437,518,81,0.156370656370656,0.182606726958602
"S01000348",739,875,136,0.155428571428571,0.184656182848301
"S01000349",549,640,91,0.1421875,0.215736537744452
"S01000350",770,1031,261,0.253152279340446,0.0539909039653574
"S01000351",932,1103,171,0.155031731640979,0.185525665933318
"S01000352",751,847,96,0.113341204250295,0.300306869475201
"S01000353",572,728,156,0.214285714285714,0.089669860639415
"S01000354",550,659,109,0.165402124430956,0.163973153494879
"S01000355",644,749,105,0.14018691588785,0.220821063216078
"S01000356",578,654,76,0.116207951070336,0.29073739909106
"S01000357",630,746,116,0.155495978552279,0.184508857563102
"S01000358",936,1152,216,0.1875,0.125381567931072
"S01000359",784,902,118,0.130820399113082,0.246090728224997
"S01000360",470,530,60,0.113207547169811,0.300759866478133
"S01000361",556,664,108,0.162650602409639,0.16945996881145
"S01000362",870,959,89,0.0928050052137643,0.377577802440634
"S01000363",884,1033,149,0.144240077444337,0.210629615487897
"S01000364",832,950,118,0.124210526315789,0.2654588508395
"S01000365",597,688,91,0.132267441860465,0.242024275612656
"S01000366",720,789,69,0.0874524714828897,0.400456117262743
"S01000367",711,800,89,0.11125,0.307465319980538
"S01000368",725,879,154,0.175199089874858,0.145710656519937
"S01000369",909,1040,131,0.125961538461538,0.260198889813361
"S01000370",727,875,148,0.169142857142857,0.156770223814535
"S01000371",860,1011,151,0.149357072205737,0.198368612905192
"S01000372",906,1040,134,0.128846153846154,0.251737887707457
"S01000373",508,620,112,0.180645161290323,0.136370435635457
"S01000374",651,782,131,0.167519181585678,0.159860937328565
"S01000375",622,688,66,0.0959302325581395,0.364770295122416
"S01000376",836,953,117,0.122770199370409,0.26985704971352
"S01000377",674,776,102,0.131443298969072,0.244332789216917
"S01000378",540,621,81,0.130434782608696,0.247184706121866
"S01000379",490,606,116,0.191419141914191,0.11946331410906
"S01000380",706,800,94,0.1175,0.286514852854552
"S01000381",896,1001,105,0.104895104895105,0.330171301614768
"S01000382",680,825,145,0.175757575757576,0.144727027231079
"S01000383",671,758,87,0.114775725593668,0.295483439293368
"S01000384",677,788,111,0.140862944162437,0.219090987052181
"S01000385",510,621,111,0.178743961352657,0.139567969175043
"S01000386",706,810,104,0.128395061728395,0.25304445310095
"S01000387",803,906,103,0.113686534216336,0.29913930204401
"S01000388",635,865,230,0.265895953757225,0.0454544260440859
"S01000389",547,705,158,0.224113475177305,0.0790646027866592
"S01000390",680,774,94,0.121447028423773,0.273955182306914
"S01000391",556,710,154,0.216901408450704,0.086729017913027
"S01000392",607,767,160,0.208604954367666,0.0963680944024466
"S01000393",797,907,110,0.121278941565601,0.27447977140841
"S01000394",606,775,169,0.218064516129032,0.0854494391576197
"S01000395",664,798,134,0.167919799498747,0.159093296288464
"S01000396",876,988,112,0.11336032388664,0.300242118513106
"S01000397",972,1072,100,0.0932835820895522,0.375590670191199
"S01000398",655,830,175,0.210843373493976,0.0936768063288784
"S01000399",515,637,122,0.191522762951334,0.119310308060029
"S01000400",641,752,111,0.147606382978723,0.202489211521525
"S01000401",748,894,146,0.16331096196868,0.168128287991522
"S01000402",565,745,180,0.241610738255034,0.0629392771391756
"S01000403",747,853,106,0.124267291910903,0.265286839920889
"S01000404",698,822,124,0.150851581508516,0.194910865886385
"S01000405",543,616,73,0.118506493506494,0.283263863466152
"S01000406",568,697,129,0.185078909612626,0.12916819064381
"S01000407",603,719,116,0.161335187760779,0.172140958791863
"S01000408",449,553,104,0.188065099457505,0.124512254550002
"S01000409",635,723,88,0.121715076071923,0.27312048814106
"S01000410",599,697,98,0.140602582496413,0.219755848936389
"S01000411",561,704,143,0.203125,0.103252843625471
"S01000412",742,841,99,0.117717003567182,0.285811102239727
"S01000413",724,846,122,0.144208037825059,0.210708488424212
"S01000414",683,790,107,0.135443037974684,0.233311488220271
"S01000415",557,646,89,0.137770897832817,0.227105039704111
"S01000416",592,722,130,0.18005540166205,0.1373551955478
"S01000417",933,1048,115,0.109732824427481,0.312754531560992
"S01000418",652,791,139,0.175726927939317,0.144780850108254
"S01000419",609,723,114,0.157676348547718,0.179800110119612
"S01000420",915,1095,180,0.164383561643836,0.165985346312033
"S01000421",537,656,119,0.18140243902439,0.135115279277519
"S01000422",656,772,116,0.150259067357513,0.196275182749961
"S01000423",855,942,87,0.0923566878980892,0.379447870053024
"S01000424",640,769,129,0.167750325097529,0.159417627603039
"S01000425",718,838,120,0.143198090692124,0.21320837302983
"S01000426",735,863,128,0.148319814600232,0.200800797671281
"S01000427",708,849,141,0.166077738515901,0.162650601787653
"S01000428",721,851,130,0.152761457109283,0.190571102442559
"S01000429",745,825,80,0.096969696969697,0.360597940497292
"S01000430",522,603,81,0.134328358208955,0.236337103511709
"S01000431",633,752,119,0.158244680851064,0.178590640262745
"S01000432",895,1060,165,0.155660377358491,0.184149990383409
"S01000433",485,549,64,0.116575591985428,0.289530247454016
"S01000434",629,747,118,0.157965194109772,0.179184498816345
"S01000435",522,595,73,0.122689075630252,0.270106709786983
"S01000436",658,736,78,0.105978260869565,0.326197623563249
"S01000437",950,1095,145,0.132420091324201,0.241598849107639
"S01000438",655,771,116,0.150453955901427,0.195825488867551
"S01000439",616,795,179,0.225157232704403,0.0780074057561348
"S01000440",823,927,104,0.112189859762675,0.304229280740975
"S01000441",800,928,128,0.137931034482759,0.226683603446804
"S01000442",806,936,130,0.138888888888889,0.22417745303365
"S01000443",533,630,97,0.153968253968254,0.187873962690817
"S01000444",529,622,93,0.14951768488746,0.19799438469643
"S01000445",895,1039,144,0.138594802694899,0.224944240330493
"S01000446",849,1007,158,0.156901688182721,0.181460539149038
"S01000447",518,556,38,0.0683453237410072,0.49266269885917
"S01000448",571,695,124,0.17841726618705,0.140124164647582
"S01000449",700,823,123,0.149453219927096,0.198144511917244
"S01000450",599,706,107,0.151558073654391,0.193295264012771
"S01000451",715,860,145,0.168604651162791,0.157788702718927
"S01000452",497,614,117,0.190553745928339,0.120748063903298
"S01000453",523,595,72,0.121008403361345,0.275326003870937
"S01000454",444,535,91,0.170093457943925,0.154985789852308
"S01000455",797,956,159,0.166317991631799,0.162182612230597
"S01000456",650,783,133,0.169859514687101,0.155423235596744
"S01000457",811,925,114,0.123243243243243,0.268405378766943
"S01000458",773,924,151,0.163419913419913,0.167909483991222
"S01000459",966,1120,154,0.1375,0.227819575057808
"S01000460",711,802,91,0.113466334164589,0.299883329800403
"S01000461",793,933,140,0.15005359056806,0.196750314713616
"S01000462",963,1101,138,0.125340599455041,0.262053329232338
"S01000463",636,1008,372,0.369047619047619,0.00999921336170334
"S01000464",694,828,134,0.161835748792271,0.171116282530838
"S01000465",586,696,110,0.158045977011494,0.179012667484754
"S01000466",749,867,118,0.136101499423299,0.231540625522671
"S01000467",573,677,104,0.153618906942393,0.188651182951732
"S01000468",497,557,60,0.107719928186715,0.319898302525567
"S01000469",646,759,113,0.148880105401845,0.199483702816823
"S01000470",1119,1364,245,0.179618768328446,0.13808838871591
"S01000471",550,631,81,0.128367670364501,0.253123986989289
"S01000472",802,876,74,0.0844748858447489,0.41371628968208
"S01000473",711,826,115,0.139225181598063,0.223303502032128
"S01000474",593,698,105,0.150429799426934,0.195881178124106
"S01000475",777,933,156,0.167202572347267,0.160469962285367
"S01000476",518,625,107,0.1712,0.152931667535318
"S01000477",746,824,78,0.0946601941747573,0.369927108407023
"S01000478",827,925,98,0.105945945945946,0.326315548727139
"S01000479",910,1011,101,0.0999010880316518,0.349061834904926
"S01000480",645,703,58,0.0825035561877667,0.422711337498842
"S01000481",746,830,84,0.101204819277108,0.344038741995968
"S01000482",733,916,183,0.199781659388646,0.107667594386182
"S01000483",899,1058,159,0.150283553875236,0.196218630542358
"S01000484",717,898,181,0.201559020044543,0.105299956070578
"S01000485",1042,1141,99,0.0867659947414549,0.403478823174775
"S01000486",728,1019,291,0.285574092247301,0.0346395269949825
"S01000487",531,625,94,0.1504,0.195949896027365
"S01000488",674,762,88,0.115485564304462,0.293122564738814
"S01000489",825,1006,181,0.179920477137177,0.137581385387253
"S01000490",490,574,84,0.146341463414634,0.205514219632257
"S01000491",542,650,108,0.166153846153846,0.162502220205864
"S01000492",860,1041,181,0.173871277617675,0.148073457532223
"S01000493",548,630,82,0.13015873015873,0.247970541443247
"S01000494",517,612,95,0.155228758169935,0.18509351779373
"S01000495",902,1012,110,0.108695652173913,0.316417321868319
"S01000496",502,613,111,0.181076672104405,0.135653944411048
"S01000497",598,660,62,0.0939393939393939,0.372882914523227
"S01000498",508,587,79,0.13458262350937,0.235643850349588
"S01000499",732,866,134,0.15473441108545,0.186179513192543
"S01000500",652,722,70,0.0969529085872576,0.360664985452525
"S01000501",588,661,73,0.110438729198185,0.310283488754836
"S01000502",497,577,80,0.138648180242634,0.224804890992612
"S01000503",472,572,100,0.174825174825175,0.146372570066628
"S01000504",667,838,171,0.204057279236277,0.102051208693653
"S01000505",712,819,107,0.130647130647131,0.246581743359014
"S01000506",587,709,122,0.172073342736248,0.151327779890612
"S01000507",1039,1149,110,0.0957354221061793,0.365557070809744
"S01000508",803,944,141,0.149364406779661,0.198351509456068
"S01000509",1000,1097,97,0.0884229717411121,0.396217564643245
"S01000510",614,706,92,0.130311614730878,0.247535049350815
"S01000511",525,601,76,0.126455906821963,0.258730908826969
"S01000512",804,950,146,0.153684210526316,0.188505677316783
"S01000513",797,912,115,0.12609649122807,0.259797418095612
"S01000514",469,571,102,0.178633975481611,0.139754996829564
"S01000515",532,603,71,0.117744610281924,0.285721684278636
"S01000516",630,685,55,0.0802919708029197,0.433011848000399
"S01000517",602,700,98,0.14,0.221301578888031
"S01000518",816,921,105,0.11400651465798,0.298061090171195
"S01000519",450,493,43,0.0872210953346856,0.401472631806865
"S01000520",936,1088,152,0.139705882352941,0.222059590071636
"S01000521",866,980,114,0.116326530612245,0.290347548336254
"S01000522",573,657,84,0.127853881278539,0.254620006021745
"S01000523",756,863,107,0.123986095017381,0.266139905208292
"S01000524",600,692,92,0.132947976878613,0.24013284114052
"S01000525",912,1043,131,0.125599232981783,0.261279477570005
"S01000526",896,1043,147,0.140939597315436,0.218895590127684
"S01000527",556,637,81,0.127158555729984,0.256657282998791
"S01000528",759,926,167,0.180345572354212,0.136869881779063
"S01000529",666,787,121,0.153748411689962,0.188362726499963
"S01000530",427,525,98,0.186666666666667,0.126673484214774
"S01000531",487,582,95,0.163230240549828,0.168290563901805
"S01000532",735,874,139,0.159038901601831,0.17691272193602
"S01000533",718,811,93,0.114673242909988,0.295825699638675
"S01000534",751,858,107,0.124708624708625,0.263952932625966
"S01000535",921,1033,112,0.108422071636012,0.317389888510108
"S01000536",486,559,73,0.130590339892665,0.24674287103221
"S01000537",532,606,74,0.122112211221122,0.271888025805893
"S01000538",739,845,106,0.125443786982249,0.261744337137116
"S01000539",920,1125,205,0.182222222222222,0.133768251065037
"S01000540",743,856,113,0.132009345794393,0.242745110474573
"S01000541",495,610,115,0.188524590163934,0.123809405783115
"S01000542",623,718,95,0.132311977715877,0.241900086783683
"S01000543",763,862,99,0.114849187935035,0.295238317221802
"S01000544",707,784,77,0.0982142857142857,0.35565876092834
"S01000545",657,762,105,0.137795275590551,0.227040838585151
"S01000546",627,739,112,0.151556156968877,0.19329963072294
"S01000547",509,582,73,0.125429553264605,0.261786940091681
"S01000548",962,1047,85,0.0811843361986628,0.428828759369995
"S01000549",1032,1197,165,0.137844611528822,0.226910957726574
"S01000550",537,600,63,0.105,0.329784586096516
"S01000551",781,866,85,0.0981524249422633,0.355902811350085
"S01000552",533,589,56,0.0950764006791171,0.368229978343268
"S01000553",902,1015,113,0.111330049261084,0.307188499745807
"S01000554",692,866,174,0.200923787528868,0.106140718796814
"S01000555",838,949,111,0.116965226554268,0.288255804996792
"S01000556",809,952,143,0.150210084033613,0.196388354951214
"S01000557",813,943,130,0.137857900318134,0.226875985344439
"S01000558",527,618,91,0.147249190938511,0.203339336090257
"S01000559",648,751,103,0.137150466045273,0.2287445148027
"S01000560",961,1126,165,0.146536412078153,0.2050453720431
"S01000561",947,1122,175,0.155971479500891,0.183472602288294
"S01000562",872,1029,157,0.152575315840622,0.19099020800281
"S01000563",552,749,197,0.2630173564753,0.0472685848413235
"S01000564",807,1060,253,0.238679245283019,0.0654149019205941
"S01000565",661,760,99,0.130263157894737,0.247673004202307
"S01000566",757,969,212,0.218782249742002,0.0846683359794655
"S01000567",732,835,103,0.123353293413174,0.268068667601912
"S01000568",516,578,62,0.107266435986159,0.321527876350385
"S01000569",706,795,89,0.111949685534591,0.305053297539192
"S01000570",887,1003,116,0.115653040877368,0.292568030477734
"S01000571",709,825,116,0.140606060606061,0.219746955251085
"S01000572",765,841,76,0.0903686087990487,0.387841603363784
"S01000573",572,663,91,0.137254901960784,0.228467802182885
"S01000574",765,848,83,0.097877358490566,0.356989817630145
"S01000575",608,708,100,0.141242937853107,0.218123880748947
"S01000576",567,696,129,0.185344827586207,0.128747318599518
"S01000577",553,629,76,0.120826709062003,0.275895653499523
"S01000578",679,744,65,0.0873655913978495,0.400837539270054
"S01000579",725,867,142,0.163783160322953,0.167181836223666
"S01000580",516,719,203,0.282336578581363,0.0362416625630848
"S01000581",669,746,77,0.103217158176944,0.336413103078248
"S01000582",686,786,100,0.127226463104326,0.256457672615019
"S01000583",709,813,104,0.127921279212792,0.254423308523932
"S01000584",702,849,147,0.173144876325088,0.149380606662967
"S01000585",850,1042,192,0.18426103646833,0.130470422125275
"S01000586",727,818,91,0.111246943765281,0.307475893265794
"S01000587",710,815,105,0.128834355828221,0.251771982593632
"S01000588",558,680,122,0.179411764705882,0.13843721770605
"S01000589",594,693,99,0.142857142857143,0.214058315601308
"S01000590",708,840,132,0.157142857142857,0.180942137447462
"S01000591",620,681,61,0.0895741556534508,0.391242275245658
"S01000592",857,971,114,0.11740473738414,0.286824285336672
"S01000593",527,615,88,0.143089430894309,0.213478918697684
"S01000594",596,684,88,0.128654970760234,0.252290896615871
"S01000595",781,900,119,0.132222222222222,0.242150429886044
"S01000596",882,998,116,0.11623246492986,0.29065676693047
"S01000597",1036,1118,82,0.073345259391771,0.466852317027136
"S01000598",447,537,90,0.167597765363128,0.159710097321069
"S01000599",767,883,116,0.131370328425821,0.244538139522072
"S01000600",673,773,100,0.129366106080207,0.250239407481991
"S01000601",1008,1163,155,0.133276010318143,0.239225887153995
"S01000602",620,736,116,0.157608695652174,0.179944572350725
"S01000603",787,867,80,0.0922722029988466,0.379801214212121
"S01000604",988,1140,152,0.133333333333333,0.2390677160551
"S01000605",800,941,141,0.149840595111583,0.19724392480966
"S01000606",679,924,245,0.265151515151515,0.0459174784248276
"S01000607",736,837,101,0.120669056152927,0.276390787598527
"S01000608",830,1102,272,0.246823956442831,0.0587441979447425
"S01000609",890,1131,241,0.213085764809903,0.0910487561661761
"S01000610",658,920,262,0.284782608695652,0.0350252031309268
"S01000611",568,695,127,0.18273381294964,0.13293376684641
"S01000612",884,1128,244,0.216312056737589,0.0873839462795916
"S01000613",909,1112,203,0.182553956834532,0.13322660463402
"S01000614",653,769,116,0.150845253576073,0.194925391311228
"S01000615",677,853,176,0.206330597889801,0.0991736677701184
"S01000616",1035,1449,414,0.285714285714286,0.0345716130336078
"S01000617",567,673,106,0.157503714710253,0.180168949645252
"S01000618",785,869,84,0.096662830840046,0.361825193442057
"S01000619",615,814,199,0.244471744471744,0.0606048120702128
"S01000620",728,1014,286,0.282051282051282,0.0363859939658591
"S01000621",906,1108,202,0.182310469314079,0.133623970689845
"S01000622",426,599,173,0.28881469115192,0.0330999827263833
"S01000623",734,836,102,0.12200956937799,0.272206082121874
"S01000624",567,641,74,0.115444617784711,0.293258287221152
"S01000625",613,749,136,0.181575433911883,0.134830010452841
"S01000626",753,935,182,0.194652406417112,0.11477139313281
"S01000627",875,1004,129,0.128486055776892,0.252780403139567
"S01000628",528,638,110,0.172413793103448,0.150706657615591
"S01000629",580,775,195,0.251612903225806,0.055114124198636
"S01000630",682,791,109,0.137800252844501,0.227027732526651
"S01000631",585,687,102,0.148471615720524,0.20044318280916
"S01000632",550,640,90,0.140625,0.219698532039712
"S01000633",581,677,96,0.141802067946824,0.216707846813567
"S01000634",747,899,152,0.169076751946607,0.15689499902637
"S01000635",635,712,77,0.10814606741573,0.318373796700674
"S01000636",447,539,92,0.170686456400742,0.153881913993465
"S01000637",550,639,89,0.139280125195618,0.223161007456895
"S01000638",461,531,70,0.131826741996234,0.243256269962209
"S01000639",556,650,94,0.144615384615385,0.209707686627954
"S01000640",606,706,100,0.141643059490085,0.217109701950883
"S01000641",734,856,122,0.142523364485981,0.214893338216454
"S01000642",754,882,128,0.145124716553288,0.208462339493544
"S01000643",586,660,74,0.112121212121212,0.304464600095452
"S01000644",626,716,90,0.125698324022346,0.260983534826461
"S01000645",785,1010,225,0.222772277227723,0.0804419944177832
"S01000646",779,884,105,0.118778280542986,0.282391699170012
"S01000647",818,937,119,0.127001067235859,0.257120750955072
"S01000648",824,988,164,0.165991902834008,0.162818095742066
"S01000649",529,647,118,0.182380216383308,0.133510036201792
"S01000650",695,788,93,0.118020304568528,0.284830092564739
"S01000651",712,879,167,0.189988623435722,0.121593731282504
"S01000652",750,860,110,0.127906976744186,0.254465038127744
"S01000653",872,1057,185,0.175023651844844,0.146020884992173
"S01000654",853,1029,176,0.171039844509232,0.153227446438478
"S01000655",700,918,218,0.237472766884532,0.0664589672385544
"S01000656",704,882,178,0.201814058956916,0.10496408882781
"S01000657",683,823,140,0.170109356014581,0.154956102622252
"S01000658",507,638,131,0.205329153605016,0.100432160678362
"S01000659",949,1128,179,0.158687943262411,0.177652419970883
"S01000660",902,1020,118,0.115686274509804,0.292458102420821
"S01000661",697,842,145,0.172209026128266,0.151079961674008
"S01000662",494,568,74,0.130281690140845,0.247620235401874
"S01000663",650,754,104,0.137931034482759,0.226683603446804
"S01000664",715,830,115,0.13855421686747,0.225050247167338
"S01000665",612,732,120,0.163934426229508,0.166879661774604
"S01000666",455,551,96,0.174228675136116,0.147434111894897
"S01000667",912,1061,149,0.140433553251649,0.220188455061865
"S01000668",844,989,145,0.146612740141557,0.204862066987639
"S01000669",712,870,158,0.181609195402299,0.134774400963906
"S01000670",496,601,105,0.174708818635607,0.146579098005395
"S01000671",551,679,128,0.188512518409426,0.123827825279155
"S01000672",586,705,119,0.168794326241135,0.157429091883886
"S01000673",680,824,144,0.174757281553398,0.146493046268849
"S01000674",859,1106,247,0.223327305605787,0.0798693902006758
"S01000675",671,758,87,0.114775725593668,0.295483439293368
"S01000676",446,552,106,0.192028985507246,0.11856535605286
"S01000677",710,921,211,0.229098805646037,0.0741288367696213
"S01000678",909,1077,168,0.155988857938719,0.183434829017307
"S01000679",628,861,233,0.27061556329849,0.0426152384491731
"S01000680",695,855,160,0.187134502923977,0.125946730690752
"S01000681",698,948,250,0.263713080168776,0.046824252478813
"S01000682",530,780,250,0.320512820512821,0.0209803471094036
"S01000683",471,604,133,0.220198675496689,0.0831456791526091
"S01000684",594,773,179,0.231565329883571,0.0717909186411971
"S01000685",751,924,173,0.187229437229437,0.125799715181613
"S01000686",634,828,194,0.234299516908213,0.0692770220803581
"S01000687",747,858,111,0.129370629370629,0.250226406850379
"S01000688",728,866,138,0.159353348729792,0.17625233244312
"S01000689",516,667,151,0.226386806596702,0.0767783327456905
"S01000690",751,859,108,0.125727590221187,0.260896186879984
"S01000691",725,825,100,0.121212121212121,0.274688564773928
"S01000692",639,904,265,0.293141592920354,0.0311404064553187
"S01000693",831,1030,199,0.193203883495146,0.116852495278343
"S01000694",663,769,106,0.137841352405722,0.226919535569201
"S01000695",691,803,112,0.13947696139477,0.222651190161725
"S01000696",659,810,151,0.18641975308642,0.127058568232962
"S01000697",436,531,95,0.178907721280603,0.139289917728825
"S01000698",586,695,109,0.156834532374101,0.181605130805866
"S01000699",593,719,126,0.175243393602225,0.145632407757747
"S01000700",828,930,102,0.109677419354839,0.312949226385742
"S01000701",873,990,117,0.118181818181818,0.284308923587771
"S01000702",501,564,63,0.111702127659574,0.305904748734651
"S01000703",691,811,120,0.147965474722565,0.201637791306068
"S01000704",734,983,249,0.253306205493388,0.0538797312533436
"S01000705",1043,1234,191,0.154781199351702,0.186076482296204
"S01000706",754,898,144,0.160356347438753,0.174160672104488
"S01000707",484,585,101,0.172649572649573,0.150277843966959
"S01000708",498,615,117,0.190243902439024,0.121211065765558
"S01000709",834,918,84,0.0915032679738562,0.383030797189634
"S01000710",952,1220,268,0.219672131147541,0.0837088117408655
"S01000711",571,656,85,0.129573170731707,0.249644894498684
"S01000712",530,655,125,0.190839694656489,0.120322181167466
"S01000713",789,886,97,0.109480812641084,0.313640987976134
"S01000714",779,896,117,0.130580357142857,0.246771204046409
"S01000715",589,739,150,0.20297699594046,0.103444776095638
"S01000716",527,716,189,0.263966480446927,0.0466633516239954
"S01000717",899,1083,184,0.169898430286242,0.155350391148393
"S01000718",904,1017,113,0.111111111111111,0.307946147657439
"S01000719",614,729,115,0.157750342935528,0.17964222613916
"S01000720",803,932,129,0.138412017167382,0.225422015890461
"S01000721",616,728,112,0.153846153846154,0.188145280374965
"S01000722",787,875,88,0.100571428571429,0.346470923269261
"S01000723",492,559,67,0.119856887298748,0.278954228373634
"S01000724",806,908,102,0.112334801762115,0.303732967204472
"S01000725",622,782,160,0.20460358056266,0.101352931897519
"S01000726",718,804,86,0.106965174129353,0.322614553454177
"S01000727",639,770,131,0.17012987012987,0.154917803193219
"S01000728",696,816,120,0.147058823529412,0.203793725481126
"S01000729",499,596,97,0.162751677852349,0.169255526788442
"S01000730",442,609,167,0.274220032840722,0.0405555006601555
"S01000731",485,618,133,0.215210355987055,0.0886201814947183
"S01000732",453,626,173,0.276357827476038,0.0393766429823637
"S01000733",688,869,181,0.208285385500575,0.0967579409613507
"S01000734",833,998,165,0.165330661322645,0.164113610926518
"S01000735",454,529,75,0.141776937618147,0.216771313024476
"S01000736",715,824,109,0.132281553398058,0.241984919192254
"S01000737",538,647,109,0.168469860896445,0.158044704928385
"S01000738",557,614,57,0.0928338762214984,0.377457657480528
"S01000739",720,812,92,0.113300492610837,0.300444786242176
"S01000740",779,896,117,0.130580357142857,0.246771204046409
"S01000741",902,1021,119,0.116552399608227,0.289606266273358
"S01000742",498,585,87,0.148717948717949,0.199864088273339
"S01000743",655,780,125,0.16025641025641,0.174368074995273
"S01000744",638,812,174,0.214285714285714,0.089669860639415
"S01000745",667,801,134,0.16729088639201,0.160299873016686
"S01000746",666,805,139,0.172670807453416,0.150239278059539
"S01000747",521,619,98,0.158319870759289,0.178431178039165
"S01000748",532,670,138,0.205970149253731,0.0996249911770195
"S01000749",513,610,97,0.159016393442623,0.176960077983156
"S01000750",608,745,137,0.183892617449664,0.131060875645828
"S01000751",666,768,102,0.1328125,0.240508312632575
"S01000752",902,1091,189,0.173235563703025,0.149216850630877
"S01000753",613,680,67,0.0985294117647059,0.354417875646744
"S01000754",573,689,116,0.168359941944848,0.158253746608141
"S01000755",748,858,110,0.128205128205128,0.253596409375097
"S01000756",971,1185,214,0.180590717299578,0.136461077330816
"S01000757",623,770,147,0.190909090909091,0.120219028718695
"S01000758",921,1063,142,0.133584195672625,0.238376619571769
"S01000759",914,1098,184,0.167577413479053,0.159749150063765
"S01000760",511,602,91,0.151162790697674,0.194197703030306
"S01000761",560,684,124,0.181286549707602,0.135306684644285
"S01000762",623,720,97,0.134722222222222,0.235264013857649
"S01000763",789,960,171,0.178125,0.140623434833248
"S01000764",640,780,140,0.179487179487179,0.138310041914343
"S01000765",513,806,293,0.363523573200993,0.0109099618781108
"S01000766",668,835,167,0.2,0.1073741824
"S01000767",542,654,112,0.171253822629969,0.152832382067729
"S01000768",720,915,195,0.213114754098361,0.0910152200954761
"S01000769",820,1087,267,0.245630174793008,0.0596819607862352
"S01000770",556,630,74,0.117460317460317,0.286643713340766
"S01000771",863,1087,224,0.206071757129715,0.0994975796361961
"S01000772",595,696,101,0.145114942528736,0.208486174793228
"S01000773",871,1006,135,0.134194831013916,0.236701899380824
"S01000774",458,745,287,0.385234899328859,0.00771066886189787
"S01000775",618,754,136,0.180371352785146,0.136826838454554
"S01000776",573,658,85,0.129179331306991,0.250776757965697
"S01000777",433,645,212,0.328682170542636,0.018590103905674
"S01000778",470,597,127,0.212730318257956,0.091460857337917
"S01000779",676,940,264,0.280851063829787,0.036998866860053
"S01000780",865,1025,160,0.15609756097561,0.183198714002035
"S01000781",832,955,123,0.128795811518325,0.251883400092224
"S01000782",648,782,134,0.171355498721228,0.152644980625515
"S01000783",456,565,109,0.192920353982301,0.117263795899617
"S01000784",815,954,139,0.145702306079665,0.207058155221628
"S01000785",750,859,109,0.126891734575087,0.257442945439139
"S01000786",718,826,108,0.130750605326877,0.246288406717108
"S01000787",481,586,105,0.179180887372014,0.138827212491362
"S01000788",658,762,104,0.136482939632546,0.230520324756892
"S01000789",608,697,89,0.127690100430416,0.255098562742793
"S01000790",530,687,157,0.228529839883552,0.0746777673662489
"S01000791",572,684,112,0.16374269005848,0.167262764596689
"S01000792",605,777,172,0.221364221364221,0.0819112509461629
"S01000793",718,895,177,0.197765363128492,0.110411443870245
"S01000794",739,940,201,0.213829787234043,0.090191549445586
"S01000795",708,822,114,0.138686131386861,0.22470586163801
"S01000796",492,605,113,0.186776859504132,0.126501967777102
"S01000797",535,652,117,0.179447852760736,0.138376347453446
"S01000798",507,559,52,0.0930232558139535,0.376670418400122
"S01000799",1888,2888,1000,0.346260387811634,0.0142576520122917
"S01000800",930,1098,168,0.153005464480874,0.190022962431432
"S01000801",579,676,97,0.143491124260355,0.212480303420462
"S01000802",704,825,121,0.146666666666667,0.204732649090523
"S01000803",832,989,157,0.158746208291203,0.177529425202888
"S01000804",898,1067,169,0.158388003748828,0.178286792759326
"S01000805",772,875,103,0.117714285714286,0.285819906708398
"S01000806",769,918,149,0.162309368191721,0.170151814980462
"S01000807",709,802,93,0.115960099750623,0.291553775005123
"S01000808",638,796,158,0.198492462311558,0.109414809823753
"S01000809",495,592,97,0.163851351351351,0.167045554361886
"S01000810",567,690,123,0.178260869565217,0.140391133845145
"S01000811",772,880,108,0.122727272727273,0.269989131506185
"S01000812",573,732,159,0.217213114754098,0.0863844174983783
"S01000813",702,825,123,0.149090909090909,0.198990175845126
"S01000814",853,1028,175,0.170233463035019,0.15472452748951
"S01000815",457,636,179,0.281446540880503,0.0366936440907108
"S01000816",465,715,250,0.34965034965035,0.0135353381741607
"S01000817",832,968,136,0.140495867768595,0.220028880872267
"S01000818",678,884,206,0.233031674208145,0.0704326921151126
"S01000819",728,879,151,0.171786120591581,0.151853582579401
"S01000820",535,644,109,0.169254658385093,0.156559399407378
"S01000821",781,986,205,0.207910750507099,0.0972167703795138
"S01000822",543,655,112,0.170992366412214,0.153315228979163
"S01000823",512,652,140,0.214723926380368,0.0891710031649236
"S01000824",593,708,115,0.162429378531073,0.169908206936408
"S01000825",627,790,163,0.206329113924051,0.0991755220883544
"S01000826",670,771,101,0.130998702983139,0.245586362438063
"S01000827",655,770,115,0.149350649350649,0.198383591412677
"S01000828",788,951,163,0.171398527865405,0.152565734962505
"S01000829",608,667,59,0.088455772113943,0.396075020685597
"S01000830",657,791,134,0.169405815423515,0.156274767202592
"S01000831",889,970,81,0.0835051546391753,0.418119350443722
"S01000832",877,1051,174,0.165556612749762,0.163669883535197
"S01000833",525,649,124,0.191063174114022,0.119990279802749
"S01000834",863,959,96,0.100104275286757,0.348274666836723
"S01000835",637,764,127,0.166230366492147,0.162353156843596
"S01000836",787,906,119,0.131346578366446,0.244605009330464
"S01000837",690,936,246,0.262820512820513,0.0473949882561964
"S01000838",695,769,74,0.0962288686605982,0.363567160138594
"S01000839",892,1014,122,0.120315581854043,0.277503837874976
"S01000840",711,854,143,0.167447306791569,0.159999011826255
"S01000841",906,1094,188,0.171846435100548,0.151743031747345
"S01000842",774,889,115,0.129358830146232,0.250260320909468
"S01000843",740,892,152,0.170403587443946,0.154407593204058
"S01000844",616,746,130,0.17426273458445,0.14737331307025
"S01000845",517,636,119,0.187106918238994,0.125989477387341
"S01000846",677,822,145,0.17639902676399,0.143604652848777
"S01000847",914,1065,151,0.141784037558685,0.216753380552073
"S01000848",659,727,68,0.09353507565337,0.374550203484876
"S01000849",508,569,61,0.107205623901582,0.321746964955384
"S01000850",587,711,124,0.174402250351617,0.147124501784137
"S01000851",620,770,150,0.194805194805195,0.114553837718008
"S01000852",664,772,108,0.139896373056995,0.221568384062986
"S01000853",525,581,56,0.0963855421686747,0.362937388667848
"S01000854",849,1024,175,0.1708984375,0.153489028069979
"S01000855",728,900,172,0.191111111111111,0.119919193410185
"S01000856",580,659,79,0.119878603945372,0.278885406863513
"S01000857",553,667,114,0.170914542728636,0.153459215560481
"S01000858",675,778,103,0.132390745501285,0.241680582170385
"S01000859",780,893,113,0.126539753639418,0.258482674128308
"S01000860",812,933,121,0.129689174705252,0.249312385929548
"S01000861",621,676,55,0.0813609467455621,0.4280051969383
"S01000862",518,595,77,0.129411764705882,0.250108205474701
"S01000863",567,623,56,0.0898876404494382,0.38989720536144
"S01000864",636,696,60,0.0862068965517241,0.405955809076743
"S01000865",610,762,152,0.199475065616798,0.108080821425961
"S01000866",887,1005,118,0.117412935323383,0.286797644928728
"S01000867",635,771,136,0.176394293125811,0.143612906725002
"S01000868",651,770,119,0.154545454545455,0.186596130735599
"S01000869",512,654,142,0.217125382262997,0.0864812835002198
"S01000870",801,923,122,0.132177681473456,0.242274748038151
"S01000871",756,866,110,0.1270207852194,0.257062682299143
"S01000872",604,701,97,0.138373751783167,0.225522151736847
"S01000873",1259,1696,437,0.257665094339623,0.050815806405762
"S01000874",495,567,72,0.126984126984127,0.257170648732104
"S01000875",689,793,104,0.131147540983607,0.24516605899655
"S01000876",676,820,144,0.175609756097561,0.14498679029094
"S01000877",671,815,144,0.176687116564417,0.143103123868162
"S01000878",534,624,90,0.144230769230769,0.210652527070465
"S01000879",838,1025,187,0.182439024390244,0.133414039033837
"S01000880",733,856,123,0.143691588785047,0.21198352013352
"S01000881",659,751,92,0.122503328894807,0.270679132472487
"S01000882",859,1016,157,0.154527559055118,0.186635630757836
"S01000883",780,1022,242,0.23679060665362,0.0670559112849237
"S01000884",486,619,133,0.21486268174475,0.0890135665392879
"S01000885",493,556,63,0.113309352517986,0.300414767129727
"S01000886",700,772,72,0.0932642487046632,0.37567076288198
"S01000887",733,857,124,0.144690781796966,0.209522914793666
"S01000888",659,793,134,0.168978562421185,0.15708049919301
"S01000889",733,857,124,0.144690781796966,0.209522914793666
"S01000890",729,870,141,0.162068965517241,0.170640752254333
"S01000891",846,1000,154,0.154,0.187803477796893
"S01000892",529,654,125,0.191131498470948,0.119888972220235
"S01000893",677,795,118,0.148427672955975,0.20054664469531
"S01000894",547,646,99,0.153250773993808,0.189473328018935
"S01000895",812,1043,231,0.221476510067114,0.0817932016376878
"S01000896",439,538,99,0.184014869888476,0.130864679463799
"S01000897",650,727,77,0.105914718019257,0.326429543622695
"S01000898",537,590,53,0.0898305084745763,0.390142031076603
"S01000899",827,904,77,0.0851769911504425,0.410554475488442
"S01000900",618,714,96,0.134453781512605,0.235994908387397
"S01000901",606,725,119,0.164137931034483,0.166473908448953
"S01000902",899,1037,138,0.133076181292189,0.239778011062776
"S01000903",909,1022,113,0.110567514677104,0.309834571004416
"S01000904",640,738,98,0.132791327913279,0.240567038367586
"S01000905",629,776,147,0.189432989690722,0.122430392519599
"S01000906",527,595,68,0.114285714285714,0.297123152856603
"S01000907",757,930,173,0.186021505376344,0.12768189199951
"S01000908",666,845,179,0.211834319526627,0.0925071289070674
"S01000909",847,1004,157,0.156374501992032,0.18259840313804
"S01000910",765,928,163,0.175646551724138,0.144922090248204
"S01000911",880,1031,151,0.146459747817653,0.205229633068388
"S01000912",686,794,108,0.136020151133501,0.231758746253298
"S01000913",668,779,111,0.142490372272144,0.214976034751149
"S01000914",795,888,93,0.10472972972973,0.330781817235591
"S01000915",893,1045,152,0.145454545454545,0.20765944282461
"S01000916",893,1055,162,0.153554502369668,0.18879478445959
"S01000917",617,757,140,0.184940554821664,0.129387656035164
"S01000918",555,699,144,0.206008583690987,0.0995767789273152
"S01000919",594,687,93,0.135371179039301,0.233505481074308
"S01000920",462,566,104,0.183745583038869,0.13129719368405
"S01000921",691,786,95,0.120865139949109,0.275775076254921
"S01000922",765,889,124,0.139482564679415,0.222636692683056
"S01000923",689,806,117,0.145161290322581,0.208373171096792
"S01000924",829,957,128,0.133751306165099,0.237917248017569
"S01000925",857,1035,178,0.171980676328502,0.151497240152034
"S01000926",584,703,119,0.16927453769559,0.156521939578987
"S01000927",945,1111,166,0.149414941494149,0.198233703926699
"S01000928",914,1045,131,0.125358851674641,0.261998649596118
"S01000929",455,548,93,0.16970802919708,0.155707087652022
"S01000930",778,979,201,0.205311542390194,0.100454420319146
"S01000931",670,757,87,0.114927344782034,0.29497773191529
"S01000932",858,986,128,0.129817444219067,0.248945184045902
"S01000933",798,969,171,0.176470588235294,0.143479925664248
"S01000934",874,1121,247,0.220338983050847,0.0829961984396635
"S01000935",814,936,122,0.13034188034188,0.247448919347065
"S01000936",883,983,100,0.101729399796541,0.342036030396518
"S01000937",530,642,112,0.174454828660436,0.147030832185485
"S01000938",792,897,105,0.117056856187291,0.287956830999592
"S01000939",659,789,130,0.164765525982256,0.165228177999928
"S01000940",761,894,133,0.148769574944072,0.199742913238905
"S01000941",506,588,82,0.139455782312925,0.22270599485451
"S01000942",845,990,145,0.146464646464646,0.205217854812374
"S01000943",806,888,82,0.0923423423423423,0.379507847113076
"S01000944",729,842,113,0.134204275534442,0.236676080336388
"S01000945",693,829,136,0.164053075995175,0.166642986644746
"S01000946",705,820,115,0.140243902439024,0.220674751435249
"S01000947",687,749,62,0.0827770360480641,0.421453042707166
"S01000948",661,770,109,0.141558441558442,0.217323826460464
"S01000949",563,663,100,0.150829562594268,0.19496141330983
"S01000950",736,845,109,0.128994082840237,0.251310742839615
"S01000951",645,766,121,0.157963446475196,0.179188217806917
"S01000952",794,939,145,0.154419595314164,0.186874094635036
"S01000953",852,953,101,0.10598111227702,0.326187219912583
"S01000954",825,981,156,0.159021406727829,0.176949529293072
"S01000955",490,561,71,0.126559714795009,0.258423609250156
"S01000956",795,905,110,0.121546961325967,0.273643725533644
"S01000957",465,557,92,0.165170556552962,0.164428682568559
"S01000958",781,850,69,0.0811764705882353,0.428865471085241
"S01000959",638,740,102,0.137837837837838,0.226928786056269
"S01000960",508,588,80,0.136054421768707,0.231666833208187
"S01000961",798,915,117,0.127868852459016,0.254576301560601
"S01000962",536,629,93,0.14785373608903,0.201902381902439
"S01000963",693,796,103,0.129396984924623,0.250150669027851
"S01000964",800,944,144,0.152542372881356,0.191064466913606
"S01000965",591,745,154,0.206711409395973,0.0986988474678874
"S01000966",1021,1118,97,0.0867620751341682,0.403496140850982
"S01000967",518,619,101,0.163166397415186,0.168419008872969
"S01000968",892,1025,133,0.129756097560976,0.249120742620716
"S01000969",772,922,150,0.162689804772234,0.169380649094284
"S01000970",747,844,97,0.114928909952607,0.294972515543632
"S01000971",679,864,185,0.21412037037037,0.0898587386338365
"S01000972",930,1051,121,0.115128449096099,0.294308174721653
"S01000973",559,638,79,0.123824451410658,0.266631399155102
"S01000974",785,901,116,0.128745837957825,0.252027921436002
"S01000975",584,717,133,0.185495118549512,0.128509997294756
"S01000976",456,537,81,0.150837988826816,0.194942068349381
"S01000977",672,825,153,0.185454545454545,0.128574026588826
"S01000978",687,813,126,0.154981549815498,0.185635877232839
"S01000979",599,696,97,0.139367816091954,0.222933753271031
"S01000980",677,818,141,0.172371638141809,0.150783441033953
"S01000981",601,679,78,0.114874815905744,0.295152847343656
"S01000982",538,638,100,0.156739811912226,0.181809247566491
"S01000983",528,599,71,0.118530884808013,0.283185492905201
"S01000984",594,685,91,0.132846715328467,0.240413435688437
"S01000985",662,764,102,0.133507853403141,0.238586743042037
"S01000986",475,561,86,0.153297682709447,0.189368388624722
"S01000987",582,675,93,0.137777777777778,0.227086919066943
"S01000988",452,522,70,0.134099616858238,0.236962333583754
"S01000989",784,901,117,0.129855715871254,0.248835716693233
"S01000990",713,998,285,0.285571142284569,0.0346409573352225
"S01000991",448,561,113,0.201426024955437,0.105475484120246
"S01000992",825,978,153,0.156441717791411,0.182452970145664
"S01000993",824,956,132,0.138075313807531,0.22630450226594
"S01000994",972,1090,118,0.108256880733945,0.317978436697804
"S01000995",780,897,117,0.130434782608696,0.247184706121866
"S01000996",875,1144,269,0.23513986013986,0.0685204624913427
"S01000997",940,1049,109,0.103908484270734,0.33382868681358
"S01000998",541,683,142,0.207906295754026,0.0972222380419958
"S01000999",662,766,104,0.135770234986945,0.232430008488337
"S01001000",482,566,84,0.148409893992933,0.200588518371449
"S01001001",500,595,95,0.159663865546218,0.175602375277672
"S01001002",626,728,102,0.14010989010989,0.221018964049779
"S01001003",879,989,110,0.111223458038423,0.307557154911789
"S01001004",642,741,99,0.133603238866397,0.23832423129378
"S01001005",804,958,154,0.160751565762004,0.173342636063305
"S01001006",730,806,76,0.0942928039702233,0.371431030437211
"S01001007",743,858,115,0.134032634032634,0.237145702633474
"S01001008",639,828,189,0.228260869565217,0.0749385376005877
"S01001009",536,689,153,0.222060957910015,0.0811812394772963
"S01001010",677,869,192,0.220943613348677,0.082354801048376
"S01001011",576,657,81,0.123287671232877,0.268269400429952
"S01001012",790,894,104,0.116331096196868,0.290332547597537
"S01001013",756,943,187,0.1983032873807,0.10967332937629
"S01001014",560,939,379,0.403620873269436,0.00569146864224536
"S01001015",493,686,193,0.28134110787172,0.0367475200647351
"S01001016",881,1021,140,0.137120470127326,0.228824047501086
"S01001017",728,914,186,0.203501094091904,0.102766563918909
"S01001018",689,872,183,0.209862385321101,0.0948478235634743
"S01001019",867,1088,221,0.203125,0.103252843625471
"S01001020",477,573,96,0.167539267015707,0.15982237155011
"S01001021",851,1001,150,0.14985014985015,0.197221758156981
"S01001022",716,966,250,0.25879917184265,0.0500448001102814
"S01001023",906,1074,168,0.156424581005587,0.182490038637354
"S01001024",776,971,195,0.200823892893924,0.106273482792395
"S01001025",895,1065,170,0.15962441314554,0.175684835126976
"S01001026",785,859,74,0.0861466821885914,0.406223392844986
"S01001027",900,1023,123,0.120234604105572,0.277759394827447
"S01001028",693,877,184,0.209806157354618,0.0949153410223139
"S01001029",679,862,183,0.212296983758701,0.0919655313798488
"S01001030",680,789,109,0.138149556400507,0.226109648557823
"S01001031",895,1023,128,0.125122189638319,0.262708434256267
"S01001032",678,787,109,0.138500635324015,0.225190266603908
"S01001033",664,786,122,0.155216284987277,0.185120848963941
"S01001034",843,1163,320,0.275150472914875,0.0400385737752575
"S01001035",504,598,94,0.157190635451505,0.180839594514334
"S01001036",477,590,113,0.191525423728814,0.119306381499519
"S01001037",806,946,140,0.147991543340381,0.201576107246161
"S01001038",707,857,150,0.175029171528588,0.146011115441318
"S01001039",480,606,126,0.207920792079208,0.097204446597545
"S01001040",568,676,108,0.159763313609467,0.175394672450778
"S01001041",542,635,93,0.146456692913386,0.205236978556524
"S01001042",737,944,207,0.219279661016949,0.0841307839150267
"S01001043",647,785,138,0.175796178343949,0.144659260029238
"S01001044",919,1046,127,0.121414913957935,0.27405533986097
"S01001045",658,759,101,0.133069828722003,0.239795581890106
"S01001046",457,532,75,0.140977443609023,0.218799173803989
"S01001047",626,723,97,0.134163208852006,0.236788365209154
"S01001048",587,666,79,0.118618618618619,0.282903760770769
"S01001049",632,737,105,0.14246947082768,0.215028440023227
"S01001050",880,1003,123,0.122632103688933,0.270282166411354
"S01001051",663,710,47,0.0661971830985915,0.504140742705195
"S01001052",513,626,113,0.180511182108626,0.136593589861031
"S01001053",749,850,101,0.118823529411765,0.282246730514232
"S01001054",709,850,141,0.165882352941176,0.163032089488726
"S01001055",708,849,141,0.166077738515901,0.162650601787653
"S01001056",689,780,91,0.116666666666667,0.289231901097091
"S01001057",614,755,141,0.186754966887417,0.126536027243473
"S01001058",708,829,121,0.145958986731001,0.20643687272314
"S01001059",577,696,119,0.170977011494253,0.153343628464202
"S01001060",735,814,79,0.097051597051597,0.360271030641859
"S01001061",738,815,77,0.094478527607362,0.370670079201251
"S01001062",495,588,93,0.158163265306122,0.178763450390447
"S01001063",747,846,99,0.117021276595745,0.288072888806311
"S01001064",716,848,132,0.155660377358491,0.184149990383409
"S01001065",697,799,102,0.127659574468085,0.25518784701564
"S01001066",674,771,97,0.125810635538262,0.260648472923318
"S01001067",711,834,123,0.147482014388489,0.202784847696882
"S01001068",754,917,163,0.177753544165758,0.141260292763952
"S01001069",806,956,150,0.156903765690377,0.18145606776683
"S01001070",787,898,111,0.123608017817372,0.267290766812712
"S01001071",611,713,102,0.143057503506311,0.213558471540137
"S01001072",701,829,128,0.154402895054282,0.186911005652709
"S01001073",908,1053,145,0.137701804368471,0.227287092635207
"S01001074",468,537,69,0.128491620111732,0.252764264391563
"S01001075",929,1025,96,0.0936585365853659,0.374040376968247
"S01001076",724,845,121,0.143195266272189,0.213215401479527
"S01001077",699,854,155,0.181498829039813,0.134956265060246
"S01001078",747,862,115,0.133410672853828,0.238854462676255
"S01001079",452,560,108,0.192857142857143,0.117355670220895
"S01001080",594,694,100,0.144092219020173,0.210993824977964
"S01001081",554,682,128,0.187683284457478,0.125099018037345
"S01001082",817,984,167,0.169715447154472,0.155693177098301
"S01001083",736,870,134,0.154022988505747,0.187752451869612
"S01001084",894,1028,134,0.130350194552529,0.247425263454178
"S01001085",843,930,87,0.0935483870967742,0.37449520439732
"S01001086",711,790,79,0.1,0.3486784401
"S01001087",514,543,29,0.0534069981583794,0.577607593535211
"S01001088",929,1071,142,0.132586367880486,0.241136210503553
"S01001089",846,1038,192,0.184971098265896,0.129339177628834
"S01001090",741,1113,372,0.334231805929919,0.0171092288916365
"S01001091",473,828,355,0.428743961352657,0.00370090587234959
"S01001092",667,1295,628,0.484942084942085,0.00131389498503243
"S01001093",642,1356,714,0.526548672566372,0.000565917840681638
"S01001094",818,1021,203,0.198824681684623,0.108962137920966
"S01001095",653,1801,1148,0.637423653525819,3.92640129744189e-05
"S01001096",620,1169,549,0.469632164242943,0.00176105039198034
"S01001097",587,666,79,0.118618618618619,0.282903760770769
"S01001098",684,1091,407,0.373052245646196,0.00938239064619139
"S01001099",572,1068,496,0.464419475655431,0.00194199345102305
"S01001100",735,1076,341,0.316914498141264,0.0221182456712995
"S01001101",591,1473,882,0.59877800407332,0.000108105388135964
"S01001102",409,973,564,0.579650565262076,0.000172228364457362
"S01001103",608,942,334,0.354564755838641,0.0125466205807256
"S01001104",475,853,378,0.443141852286049,0.00286711943457033
"S01001105",836,975,139,0.142564102564103,0.21479126581157
"S01001106",719,840,121,0.144047619047619,0.21110379623799
"S01001107",794,1186,392,0.330522765598651,0.0180866499783623
"S01001108",408,812,404,0.497536945812808,0.00102574955797038
"S01001109",578,1006,428,0.42544731610338,0.00392011291842856
"S01001110",585,1060,475,0.44811320754717,0.00262119908797031
"S01001111",767,1215,448,0.368724279835391,0.0100505738754355
"S01001112",703,900,197,0.218888888888889,0.0845528315001782
"S01001113",803,1267,464,0.366219415943173,0.0104565713201183
"S01001114",771,1027,256,0.249269717624148,0.0568642538049334
"S01001115",695,897,202,0.225195094760312,0.0779692964580784
"S01001116",555,707,152,0.214992927864215,0.0888660124685995
"S01001117",479,667,188,0.281859070464768,0.0364835251863454
"S01001118",603,663,60,0.0904977375565611,0.387291385720656
"S01001119",834,1138,304,0.26713532513181,0.044692833112309
"S01001120",599,730,131,0.179452054794521,0.138369261387197
"S01001121",671,881,210,0.238365493757094,0.0656849868903058
"S01001122",631,986,355,0.360040567951318,0.011521909057878
"S01001123",842,1023,181,0.176930596285435,0.142680485312356
"S01001124",602,682,80,0.117302052785924,0.287158162735362
"S01001125",602,812,210,0.258620689655172,0.0501654393508061
"S01001126",870,1216,346,0.284539473684211,0.0351444520789406
"S01001127",678,886,208,0.234762979683973,0.0688588427778229
"S01001128",716,790,74,0.0936708860759494,0.373989414664509
"S01001129",847,1075,228,0.212093023255814,0.0922039360395475
"S01001130",772,924,152,0.164502164502165,0.165749906143606
"S01001131",770,986,216,0.219066937119675,0.0843602974389109
"S01001132",672,820,148,0.180487804878049,0.13663256037185
"S01001133",791,1000,209,0.209,0.095888126871556
"S01001134",924,1067,143,0.134020618556701,0.237178609143747
"S01001135",512,673,161,0.239227340267459,0.0649454854702804
"S01001136",663,1012,349,0.344861660079051,0.0145656596922676
"S01001137",784,1100,316,0.287272727272727,0.0338246861245587
"S01001138",756,1126,370,0.328596802841918,0.0186137574242601
"S01001139",683,792,109,0.137626262626263,0.227486286293559
"S01001140",903,1137,234,0.205804749340369,0.0998327090534157
"S01001141",681,953,272,0.285414480587618,0.0347169938691942
"S01001142",873,1056,183,0.173295454545455,0.149108793125435
"S01001143",700,823,123,0.149453219927096,0.198144511917244
"S01001144",630,743,113,0.152086137281292,0.192095573276671
"S01001145",566,624,58,0.092948717948718,0.376980091107323
"S01001146",911,1029,118,0.114674441205053,0.295821695644508
"S01001147",502,883,381,0.431483578708947,0.00352720040491637
"S01001148",681,762,81,0.106299212598425,0.325028471663403
"S01001149",732,1004,272,0.270916334661355,0.0424398345833232
"S01001150",628,803,175,0.217932752179328,0.0855935392456068
"S01001151",718,817,99,0.121175030599755,0.274804523387068
"S01001152",906,1051,145,0.137963843958135,0.22659734472775
"S01001153",717,794,77,0.0969773299748111,0.360567461550767
"S01001154",710,814,104,0.127764127764128,0.254882159645267
"S01001155",583,691,108,0.15629522431259,0.182770068181267
"S01001156",587,924,337,0.364718614718615,0.0107068396924641
"S01001157",808,939,131,0.1395101171459,0.222565418052195
"S01001158",531,598,67,0.112040133779264,0.304742742018364
"S01001159",712,841,129,0.153388822829964,0.189164648777002
"S01001160",544,632,88,0.139240506329114,0.22326374956852
"S01001161",553,653,100,0.153139356814701,0.189722788986419
"S01001162",778,968,190,0.196280991735537,0.112471476581575
"S01001163",582,788,206,0.261421319796954,0.0483022845019839
"S01001164",545,650,105,0.161538461538462,0.171724182010141
"S01001165",707,994,287,0.288732394366197,0.0331383052433118
"S01001166",741,954,213,0.223270440251572,0.0799278871440953
"S01001167",882,998,116,0.11623246492986,0.29065676693047
"S01001168",555,845,290,0.343195266272189,0.014940417775602
"S01001169",915,1223,308,0.251839738348324,0.0549473016924311
"S01001170",748,908,160,0.176211453744493,0.143932044171618
"S01001171",526,727,201,0.276478679504814,0.0393109313274459
"S01001172",583,738,155,0.210027100271003,0.0946502857324072
"S01001173",815,974,159,0.163244353182752,0.168262182824679
"S01001174",558,822,264,0.321167883211679,0.0207789603311753
"S01001175",792,994,202,0.203219315895372,0.103130701516642
"S01001176",712,835,123,0.147305389221557,0.203205370421214
"S01001177",627,782,155,0.198209718670077,0.109801400044878
"S01001178",805,922,117,0.126898047722343,0.257424331225912
"S01001179",924,1059,135,0.127478753541076,0.255717300502588
"S01001180",621,807,186,0.230483271375465,0.0728082603868018
"S01001181",849,948,99,0.104430379746835,0.33188951239768
"S01001182",834,960,126,0.13125,0.244877101449396
"S01001183",856,1006,150,0.149105367793241,0.198956365891023
"S01001184",869,1035,166,0.160386473429952,0.174098194221048
"S01001185",554,624,70,0.112179487179487,0.304264826735471
"S01001186",769,875,106,0.121142857142857,0.274905144881704
"S01001187",836,1016,180,0.177165354330709,0.142274050168967
"S01001188",723,972,249,0.256172839506173,0.0518466050400291
"S01001189",927,1056,129,0.122159090909091,0.271742870997843
"S01001190",746,847,101,0.119244391971665,0.280901573153676
"S01001191",616,718,102,0.142061281337047,0.216054183083313
"S01001192",898,1100,202,0.183636363636364,0.131472982487443
"S01001193",810,917,107,0.116684841875682,0.289172395094666
"S01001194",889,988,99,0.100202429149798,0.347894981399393
"S01001195",909,1033,124,0.120038722168441,0.278378452980185
"S01001196",867,1083,216,0.199445983379501,0.108120092482579
"S01001197",515,574,59,0.102787456445993,0.338028537510646
"S01001198",702,848,146,0.172169811320755,0.151151547798398
"S01001199",902,1044,142,0.136015325670498,0.231771690668207
"S01001200",799,996,197,0.197791164658635,0.110375938398418
"S01001201",652,782,130,0.166240409207161,0.162333602544085
"S01001202",560,656,96,0.146341463414634,0.205514219632257
"S01001203",749,872,123,0.14105504587156,0.218601595637634
"S01001204",797,893,96,0.107502799552072,0.320677600342755
"S01001205",715,856,141,0.164719626168224,0.165319000620684
"S01001206",717,878,161,0.183371298405467,0.131900486567323
"S01001207",881,977,96,0.0982599795291709,0.355478588408014
"S01001208",653,829,176,0.212303980699638,0.0919573626708625
"S01001209",558,663,105,0.158371040723982,0.178322730431602
"S01001210",789,957,168,0.175548589341693,0.145094401137398
"S01001211",883,1015,132,0.130049261083744,0.24828278788161
"S01001212",585,696,111,0.15948275862069,0.175981195918229
"S01001213",831,1195,364,0.304602510460251,0.0264442457824985
"S01001214",679,760,81,0.106578947368421,0.324012540977956
"S01001215",746,837,91,0.108721624850657,0.316325129708987
"S01001216",886,1018,132,0.129666011787819,0.24937874720776
"S01001217",851,1008,157,0.155753968253968,0.183945970960042
"S01001218",649,857,208,0.242707117852975,0.0620352802840935
"S01001219",405,574,169,0.294425087108014,0.030579565349701
"S01001220",519,587,68,0.115843270868825,0.291939302456221
"S01001221",607,700,93,0.132857142857143,0.240384527508215
"S01001222",923,1219,296,0.242821985233798,0.0619412483917802
"S01001223",727,847,120,0.141676505312869,0.217025120127476
"S01001224",900,1069,169,0.158091674462114,0.17891553124435
"S01001225",937,1020,83,0.0813725490196078,0.4279511435933
"S01001226",725,973,248,0.254881808838643,0.0527535466764688
"S01001227",690,823,133,0.161603888213852,0.171590229557882
"S01001228",793,884,91,0.102941176470588,0.33744983726976
"S01001229",725,812,87,0.107142857142857,0.321973236590696
"S01001230",806,961,155,0.161290322580645,0.172233069423924
"S01001231",699,773,74,0.0957309184993532,0.365575277452549
"S01001232",461,724,263,0.363259668508287,0.0109552827745918
"S01001233",910,1081,171,0.158186864014801,0.178713345016126
"S01001234",626,760,134,0.176315789473684,0.143749853015973
"S01001235",666,921,255,0.276872964169381,0.039097230052428
"S01001236",849,1004,155,0.154382470119522,0.18695615788963
"S01001237",549,607,58,0.0955518945634267,0.366299675347608
"S01001238",729,935,206,0.220320855614973,0.0830154974126018
"S01001239",764,986,222,0.225152129817444,0.0780125432470859
"S01001240",757,869,112,0.128883774453395,0.251629196320385
"S01001241",740,846,106,0.125295508274232,0.26218845652481
"S01001242",793,970,177,0.182474226804124,0.133356604952839
"S01001243",462,688,226,0.328488372093023,0.0186438402580645
"S01001244",738,943,205,0.217391304347826,0.0861879777471491
"S01001245",737,887,150,0.169109357384442,0.156833444280783
"S01001246",915,1055,140,0.132701421800948,0.240816557784848
"S01001247",619,721,102,0.141470180305132,0.217547372841146
"S01001248",800,956,156,0.163179916317992,0.168391803049818
"S01001249",661,754,93,0.123342175066313,0.268102668192072
"S01001250",924,1036,112,0.108108108108108,0.318509329699947
"S01001251",671,794,123,0.154911838790932,0.185789077110815
"S01001252",603,693,90,0.12987012987013,0.248794499961089
"S01001253",588,747,159,0.21285140562249,0.0913202817206838
"S01001254",651,766,115,0.150130548302872,0.196572241243414
"S01001255",859,1050,191,0.181904761904762,0.134288445832674
"S01001256",814,912,98,0.107456140350877,0.320845288053222
"S01001257",744,898,154,0.171492204899777,0.152393340423779
"S01001258",489,589,100,0.169779286926995,0.1555735075388
"S01001259",773,857,84,0.0980163360560093,0.356440233872494
"S01001260",573,765,192,0.250980392156863,0.0555817054178628
"S01001261",834,1029,195,0.189504373177843,0.122322615548611
"S01001262",861,975,114,0.116923076923077,0.288393426824668
"S01001263",484,568,84,0.147887323943662,0.201822814984922
"S01001264",426,619,193,0.311793214862682,0.0238335920169235
"S01001265",440,619,179,0.289176090468498,0.0329321643911275
"S01001266",698,857,159,0.185530921820303,0.128453519202128
"S01001267",902,1074,172,0.160148975791434,0.17459128514838
"S01001268",702,802,100,0.124688279301746,0.264014292668081
"S01001269",480,579,99,0.170984455958549,0.153329859062694
"S01001270",775,883,108,0.122310305775764,0.271275135629324
"S01001271",748,871,123,0.141216991963261,0.218189792145175
"S01001272",657,752,95,0.126329787234043,0.259104699277592
"S01001273",659,755,96,0.127152317880795,0.256675625859612
"S01001274",708,783,75,0.0957854406130268,0.365354916830844
"S01001275",664,751,87,0.115845539280959,0.291931812483135
"S01001276",482,536,54,0.100746268656716,0.345798006652341
"S01001277",700,778,78,0.10025706940874,0.347683779692989
"S01001278",463,569,106,0.186291739894552,0.127258630788586
"S01001279",938,1077,139,0.129062209842154,0.251114245637772
"S01001280",578,630,52,0.0825396825396825,0.422544924723119
"S01001281",793,876,83,0.0947488584474886,0.369564980654349
"S01001282",697,774,77,0.0994832041343669,0.350685794673577
"S01001283",468,534,66,0.123595505617978,0.267328930218034
"S01001284",685,862,177,0.205336426914153,0.100422968897008
"S01001285",600,670,70,0.104477611940299,0.331714515954253
"S01001286",569,660,91,0.137878787878788,0.226821024923314
"S01001287",866,961,95,0.0988553590010406,0.353138480098921
"S01001288",873,970,97,0.1,0.3486784401
"S01001289",594,726,132,0.181818181818182,0.134430632749312
"S01001290",524,576,52,0.0902777777777778,0.388229055721726
"S01001291",535,603,68,0.112769485903814,0.302248879009857
"S01001292",910,1009,99,0.0981169474727453,0.356042843512095
"S01001293",744,844,100,0.118483412322275,0.283338042524684
"S01001294",713,861,148,0.171893147502904,0.15165746207834
"S01001295",858,980,122,0.124489795918367,0.264613575792743
"S01001296",701,794,93,0.117128463476071,0.287723381264315
"S01001297",721,862,141,0.163573085846868,0.167602305713649
"S01001298",797,988,191,0.19331983805668,0.116684660806388
"S01001299",863,1005,142,0.141293532338308,0.217995405065259
"S01001300",874,1025,151,0.147317073170732,0.203177528157431
"S01001301",597,693,96,0.138528138528139,0.225118385364793
"S01001302",637,740,103,0.139189189189189,0.223396891653352
"S01001303",520,681,161,0.236417033773862,0.0673848579539592
"S01001304",663,779,116,0.148908857509628,0.199416324470534
"S01001305",714,784,70,0.0892857142857143,0.39248357879171
"S01001306",667,736,69,0.09375,0.373663085628984
"S01001307",929,1061,132,0.124410933081998,0.264852026902198
"S01001308",930,1089,159,0.146005509641873,0.206324446151569
"S01001309",716,833,117,0.140456182472989,0.220130494411418
"S01001310",706,822,116,0.141119221411192,0.218438323712902
"S01001311",582,634,52,0.082018927444795,0.42494944628185
"S01001312",742,816,74,0.0906862745098039,0.38648929138798
"S01001313",631,696,65,0.0933908045977011,0.375146756864153
"S01001314",673,765,92,0.120261437908497,0.277674686813563
"S01001315",857,1028,171,0.166342412451362,0.162135110782434
"S01001316",949,1023,74,0.072336265884653,0.471960646271049
"S01001317",885,983,98,0.0996948118006104,0.349862607560956
"S01001318",507,585,78,0.133333333333333,0.2390677160551
"S01001319",631,678,47,0.0693215339233038,0.487524733721722
"S01001320",890,1001,111,0.110889110889111,0.308716108875169
"S01001321",499,604,105,0.173841059602649,0.148127628539927
"S01001322",765,908,143,0.157488986784141,0.180200447988628
"S01001323",555,690,135,0.195652173913043,0.113354541297751
"S01001324",881,1045,164,0.156937799043062,0.181382832513031
"S01001325",678,802,124,0.154613466334165,0.186446079574988
"S01001326",910,1049,139,0.132507149666349,0.241356523301174
"S01001327",719,810,91,0.112345679012346,0.303695750500209
"S01001328",790,883,93,0.105322763306908,0.328597214124593
"S01001329",563,652,89,0.136503067484663,0.230466598055159
"S01001330",937,1017,80,0.0786627335299902,0.440743970406169
"S01001331",833,915,82,0.0896174863387978,0.391056107798103
"S01001332",830,986,156,0.158215010141988,0.178653600975865
"S01001333",790,932,142,0.152360515021459,0.191474872657916
"S01001334",803,980,177,0.180612244897959,0.13642523038536
"S01001335",913,1036,123,0.118725868725869,0.282559700294967
"S01001336",877,973,96,0.0986639260020555,0.353889380856318
"S01001337",836,913,77,0.0843373493975904,0.414338222925127
"S01001338",774,859,85,0.0989522700814901,0.352758890930256
"S01001339",636,729,93,0.127572016460905,0.255444098284202
"S01001340",721,821,100,0.121802679658953,0.27284818928476
"S01001341",850,1001,151,0.150849150849151,0.194916445217557
"S01001342",811,895,84,0.093854748603352,0.373231412974272
"S01001343",954,1071,117,0.109243697478992,0.314477109273473
"S01001344",789,872,83,0.0951834862385321,0.367794459569051
"S01001345",717,918,201,0.218954248366013,0.0844821085470454
"S01001346",618,759,141,0.185770750988142,0.128075774827594
"S01001347",751,874,123,0.140732265446224,0.219424462758282
"S01001348",661,775,114,0.147096774193548,0.203703067894368
"S01001349",955,1404,449,0.31980056980057,0.0212013071528795
"S01001350",690,778,88,0.113110539845758,0.301089033422177
"S01001351",495,621,126,0.202898550724638,0.10354663442006
"S01001352",815,959,144,0.150156412930136,0.196512425332879
"S01001353",620,723,103,0.142461964038728,0.215047264270894
"S01001354",724,863,139,0.161066048667439,0.172694181291433
"S01001355",721,843,122,0.144721233689205,0.209448329521437
"S01001356",608,686,78,0.113702623906706,0.299085002230571
"S01001357",651,774,123,0.158914728682171,0.17717411775472
"S01001358",818,942,124,0.131634819532909,0.243794558980785
"S01001359",690,790,100,0.126582278481013,0.25835685813421
"S01001360",792,926,134,0.144708423326134,0.209479702801155
"S01001361",476,596,120,0.201342281879195,0.105586144010659
"S01001362",589,646,57,0.0882352941176471,0.397034062864188
"S01001363",496,687,191,0.27802037845706,0.038481269792087
"S01001364",804,967,163,0.168562564632885,0.157868596020218
"S01001365",630,698,68,0.0974212034383954,0.358799036633898
"S01001366",925,1028,103,0.100194552529183,0.347925436524155
"S01001367",698,772,74,0.0958549222797927,0.365074267817838
"S01001368",922,1124,202,0.179715302491103,0.137925986284956
"S01001369",891,1018,127,0.12475442043222,0.263814863518074
"S01001370",693,799,106,0.132665832290363,0.24091539486855
"S01001371",621,798,177,0.221804511278195,0.0814492497488357
"S01001372",739,829,90,0.108564535585042,0.316883100304932
"S01001373",559,672,113,0.168154761904762,0.158644619836999
"S01001374",578,635,57,0.0897637795275591,0.390428157537899
"S01001375",641,715,74,0.103496503496503,0.335366653459547
"S01001376",645,838,193,0.230310262529833,0.0729721193963775
"S01001377",755,865,110,0.127167630057803,0.256630601367399
"S01001378",565,633,68,0.107424960505529,0.320957388754273
"S01001379",937,1081,144,0.133209990749306,0.239408171304437
"S01001380",773,896,123,0.137276785714286,0.228409857345782
"S01001381",814,899,85,0.0945494994438265,0.37037966245711
"S01001382",575,648,73,0.112654320987654,0.302641435457646
"S01001383",592,777,185,0.238095238095238,0.0659184336634629
"S01001384",885,1028,143,0.139105058365759,0.223615323302959
"S01001385",744,918,174,0.189542483660131,0.122265110147808
"S01001386",789,1002,213,0.212574850299401,0.0916416324352014
"S01001387",754,913,159,0.174151150054765,0.147572584509993
"S01001388",799,1051,252,0.23977164605138,0.0644823167871933
"S01001389",468,562,94,0.167259786476868,0.160359751674295
"S01001390",808,909,101,0.111111111111111,0.307946147657439
"S01001391",762,926,164,0.177105831533477,0.142377002891409
"S01001392",489,565,76,0.134513274336283,0.235832748801606
"S01001393",515,590,75,0.127118644067797,0.256774666595848
"S01001394",469,620,151,0.243548387096774,0.0613495712813567
"S01001395",789,1058,269,0.254253308128544,0.053200211040075
"S01001396",633,824,191,0.231796116504854,0.0715755976784391
"S01001397",763,941,178,0.189160467587673,0.122842641137564
"S01001398",861,978,117,0.119631901840491,0.279668122366827
"S01001399",839,985,146,0.148223350253807,0.201028347797532
"S01001400",871,983,112,0.113936927772126,0.298295273329212
"S01001401",671,724,53,0.0732044198895028,0.467562357491258
"S01001402",889,989,100,0.101112234580384,0.344393299880438
"S01001403",720,1018,298,0.292730844793713,0.0313218340544234
"S01001404",545,716,171,0.238826815642458,0.0652882157015392
"S01001405",759,897,138,0.153846153846154,0.188145280374965
"S01001406",573,633,60,0.0947867298578199,0.369410401313654
"S01001407",813,883,70,0.0792751981879955,0.437822846458794
"S01001408",782,909,127,0.13971397139714,0.222038711469759
"S01001409",847,971,124,0.127703398558187,0.255059676326688
"S01001410",979,1131,152,0.134394341290893,0.236157024807503
"S01001411",535,755,220,0.291390728476821,0.0319203984557085
"S01001412",899,998,99,0.0991983967935872,0.35179649196648
"S01001413",721,810,89,0.109876543209877,0.312250008168803
"S01001414",635,721,86,0.119278779472954,0.280791919508807
"S01001415",668,892,224,0.251121076233184,0.0554773976663259
"S01001416",550,720,170,0.236111111111111,0.0676553165876237
"S01001417",966,1124,158,0.140569395017794,0.21984072713013
"S01001418",896,1006,110,0.10934393638171,0.314123399936403
"S01001419",694,793,99,0.12484237074401,0.263549885197773
"S01001420",552,682,130,0.190615835777126,0.120655474165186
"S01001421",823,862,39,0.0452436194895592,0.629398485971057
"S01001422",510,591,81,0.137055837563452,0.228995502152267
"S01001423",764,855,91,0.106432748538012,0.324543143564301
"S01001424",1012,1187,175,0.14743049705139,0.202907423136475
"S01001425",893,1052,159,0.151140684410646,0.194248283910388
"S01001426",726,859,133,0.154831199068685,0.185966436292078
"S01001427",865,977,112,0.114636642784033,0.295948019135258
"S01001428",935,1089,154,0.141414141414141,0.217689414442238
"S01001429",569,652,83,0.127300613496933,0.256239870772567
"S01001430",934,1050,116,0.11047619047619,0.310152846673895
"S01001431",995,1065,70,0.0657276995305164,0.506681129146443
"S01001432",689,803,114,0.141967621419676,0.21629016218423
"S01001433",883,999,116,0.116116116116116,0.291039646027585
"S01001434",985,1068,83,0.0777153558052434,0.445297009007413
"S01001435",934,1059,125,0.118035882908404,0.284779787241981
"S01001436",947,1038,91,0.0876685934489403,0.399508712542114
"S01001437",910,994,84,0.0845070422535211,0.413571001176005
"S01001438",581,668,87,0.130239520958084,0.247740322807595
"S01001439",759,827,68,0.0822249093107618,0.423996882538556
"S01001440",935,1047,112,0.106972301814709,0.322588805158884
"S01001441",810,872,62,0.0711009174311927,0.47828343478293
"S01001442",710,777,67,0.0862290862290862,0.405857241423783
"S01001443",902,1028,126,0.122568093385214,0.270479421459489
"S01001444",958,1093,135,0.123513266239707,0.267579890260082
"S01001445",706,791,85,0.107458912768647,0.320835322103258
"S01001446",883,953,70,0.0734522560335782,0.46631354372418
"S01001447",716,901,185,0.205327413984462,0.100434359268796
"S01001448",683,753,70,0.0929614873837981,0.376927023348676
"S01001449",572,626,54,0.0862619808306709,0.405711161596158
"S01001450",777,842,65,0.0771971496437055,0.447805345004354
"S01001451",662,761,99,0.130091984231275,0.248160883527391
"S01001452",730,831,101,0.121540312876053,0.273664436584615
"S01001453",833,958,125,0.130480167014614,0.247055725610729
"S01001454",931,1001,70,0.0699300699300699,0.484346354179629
"S01001455",753,839,86,0.102502979737783,0.339101845786486
"S01001456",618,692,74,0.106936416184971,0.322718458427185
"S01001457",880,993,113,0.113796576032226,0.298768107788406
"S01001458",932,1031,99,0.0960232783705141,0.364395051584596
"S01001459",872,972,100,0.102880658436214,0.337677559255518
"S01001460",695,732,37,0.0505464480874317,0.595301854277616
"S01001461",878,952,74,0.0777310924369748,0.445221035314665
"S01001462",833,1001,168,0.167832167832168,0.159260927002452
"S01001463",630,706,76,0.107648725212465,0.320153669561342
"S01001464",866,1005,139,0.138308457711443,0.225693110804768
"S01001465",613,704,91,0.129261363636364,0.250540623431429
"S01001466",745,809,64,0.0791100123609394,0.438608972185048
"S01001467",823,970,147,0.151546391752577,0.193321879814478
"S01001468",633,681,48,0.0704845814977974,0.481466396175679
"S01001469",776,891,115,0.129068462401796,0.251096218448085
"S01001470",955,1065,110,0.103286384976526,0.336153500495792
"S01001471",695,789,94,0.119138149556401,0.281240598715699
"S01001472",846,914,68,0.074398249452954,0.461574356666935
"S01001473",744,868,124,0.142857142857143,0.214058315601308
"S01001474",970,1251,281,0.224620303756994,0.0785496484569919
"S01001475",611,696,85,0.122126436781609,0.271843971456535
"S01001476",996,1107,111,0.100271002710027,0.34762994158972
"S01001477",995,1133,138,0.12180052956752,0.272854869503476
"S01001478",671,727,56,0.0770288858321871,0.448622543289565
"S01001479",597,696,99,0.142241379310345,0.215601071648741
"S01001480",495,586,91,0.155290102389079,0.184959153516757
"S01001481",956,1063,107,0.10065851364064,0.346135607019695
"S01001482",725,816,91,0.111519607843137,0.306533877021842
"S01001483",831,989,158,0.159757330637007,0.175407161968762
"S01001484",818,896,78,0.0870535714285714,0.402210070378199
"S01001485",693,777,84,0.108108108108108,0.318509329699947
"S01001486",789,883,94,0.106455266138165,0.324461369035586
"S01001487",647,719,72,0.100139082058414,0.348139982264396
"S01001488",903,988,85,0.0860323886639676,0.406731733094483
"S01001489",783,1055,272,0.25781990521327,0.0507099315406117
"S01001490",856,1021,165,0.161606268364349,0.17158535828824
"S01001491",847,952,105,0.110294117647059,0.310788270348238
"S01001492",936,1087,151,0.138914443422263,0.224110934495483
"S01001493",812,895,83,0.0927374301675978,0.377859146492758
"S01001494",821,959,138,0.143899895724713,0.21146840979771
"S01001495",568,627,59,0.0940988835725678,0.372227065751312
"S01001496",863,948,85,0.089662447257384,0.390863020446526
"S01001497",690,851,161,0.189189189189189,0.122799134686513
"S01001498",741,816,75,0.0919117647058824,0.381312017026029
"S01001499",964,1102,138,0.125226860254083,0.262394298343236
"S01001500",771,882,111,0.125850340136054,0.260530113809187
"S01001501",802,888,86,0.0968468468468468,0.36108880587208
"S01001502",856,989,133,0.134479271991911,0.235925416706448
"S01001503",863,982,119,0.121181262729124,0.274785036427213
"S01001504",855,1011,156,0.154302670623145,0.18713266019449
"S01001505",977,1087,110,0.101195952161914,0.344072684841441
"S01001506",516,678,162,0.238938053097345,0.0651928665623283
"S01001507",905,1031,126,0.122211445198836,0.271580847477888
"S01001508",947,1105,158,0.142986425339367,0.213735671430006
"S01001509",883,1000,117,0.117,0.288142311487668
"S01001510",548,639,91,0.142410015649452,0.215177572249903
"S01001511",597,655,58,0.0885496183206107,0.395667438460391
"S01001512",836,977,141,0.14431934493347,0.210434594400076
"S01001513",834,970,136,0.14020618556701,0.220771578950192
"S01001514",770,884,114,0.1289592760181,0.251411188787587
"S01001515",695,775,80,0.103225806451613,0.336380661928308
"S01001516",707,787,80,0.101651842439644,0.342331461635532
"S01001517",821,933,112,0.120042872454448,0.278365323701588
"S01001518",986,1064,78,0.0733082706766917,0.467038701110692
"S01001519",890,1009,119,0.117938553022795,0.285094214464326
"S01001520",718,803,85,0.105853051058531,0.326654758903788
"S01001521",941,1088,147,0.135110294117647,0.234210995834169
"S01001522",945,1036,91,0.0878378378378378,0.39876821197684
"S01001523",728,866,138,0.159353348729792,0.17625233244312
"S01001524",918,1008,90,0.0892857142857143,0.39248357879171
"S01001525",801,884,83,0.0938914027149321,0.373080466137871
"S01001526",603,685,82,0.11970802919708,0.2794263813018
"S01001527",775,920,145,0.157608695652174,0.179944572350725
"S01001528",972,1051,79,0.0751665080875357,0.457757521472156
"S01001529",608,694,86,0.123919308357349,0.266342877952889
"S01001530",830,941,111,0.117959617428268,0.285026138766931
"S01001531",774,1104,330,0.298913043478261,0.0286892287232036
"S01001532",538,630,92,0.146031746031746,0.2062610679874
"S01001533",850,940,90,0.0957446808510638,0.365519643227158
"S01001534",680,732,52,0.0710382513661202,0.47860619580248
"S01001535",899,1001,102,0.101898101898102,0.341394203140645
"S01001536",803,876,73,0.0833333333333333,0.418903887884593
"S01001537",651,733,82,0.111869031377899,0.305330465105101
"S01001538",856,956,100,0.104602510460251,0.331252163925887
"S01001539",816,937,121,0.129135538954109,0.250902898630976
"S01001540",776,883,107,0.121177802944507,0.274795854515679
"S01001541",825,941,116,0.12327311370882,0.268313949022985
"S01001542",698,795,97,0.122012578616352,0.272196752631228
"S01001543",743,810,67,0.0827160493827161,0.421733353041565
"S01001544",904,993,89,0.0896273917421954,0.391013561079687
"S01001545",764,855,91,0.106432748538012,0.324543143564301
"S01001546",873,1027,154,0.149951314508277,0.196987197258888
"S01001547",860,977,117,0.119754350051177,0.279279382298413
"S01001548",558,733,175,0.238744884038199,0.065358525062162
"S01001549",996,1189,193,0.162321278385198,0.170127624529887
"S01001550",608,718,110,0.153203342618384,0.189579489866816
"S01001551",778,881,103,0.116912599318956,0.288427646193521
"S01001552",828,921,93,0.100977198697068,0.344911016398809
"S01001553",720,893,173,0.193729003359462,0.116094160504281
"S01001554",955,1041,86,0.0826128722382325,0.422207963706725
"S01001555",749,847,98,0.115702479338843,0.292404514620139
"S01001556",880,986,106,0.107505070993915,0.320669439060265
"S01001557",962,1137,175,0.15391380826737,0.18799490250624
"S01001558",778,868,90,0.1036866359447,0.334656078843921
"S01001559",504,538,34,0.0631970260223048,0.520574160929678
"S01001560",611,722,111,0.153739612188366,0.188382313768041
"S01001561",699,801,102,0.127340823970037,0.256121830236485
"S01001562",630,722,92,0.127423822714681,0.255878336613384
"S01001563",583,696,113,0.16235632183908,0.170056466731583
"S01001564",563,624,61,0.0977564102564103,0.357468725319936
"S01001565",711,835,124,0.148502994011976,0.200369332989485
"S01001566",634,724,90,0.124309392265193,0.265159332360852
"S01001567",902,1021,119,0.116552399608227,0.289606266273358
"S01001568",666,767,101,0.131681877444589,0.243662475546326
"S01001569",444,581,137,0.235800344234079,0.0679310577858051
"S01001570",501,572,71,0.124125874125874,0.265715550087068
"S01001571",697,786,89,0.11323155216285,0.300678462322215
"S01001572",542,623,81,0.130016051364366,0.248377584263939
"S01001573",585,721,136,0.188626907073509,0.123653386137784
"S01001574",864,1010,146,0.144554455445545,0.209857109605507
"S01001575",682,859,177,0.206053550640279,0.099520398935013
"S01001576",558,651,93,0.142857142857143,0.214058315601308
"S01001577",735,819,84,0.102564102564103,0.338870975802271
"S01001578",659,714,55,0.07703081232493,0.448613179400025
"S01001579",754,911,157,0.172338090010977,0.150844572643921
"S01001580",553,662,109,0.164652567975831,0.165451770401866
"S01001581",687,771,84,0.108949416342412,0.315517600213879
"S01001582",573,641,68,0.106084243369735,0.325811136280265
"S01001583",454,522,68,0.130268199233716,0.247658648469147
"S01001584",705,806,101,0.12531017369727,0.26214450094237
"S01001585",856,1050,194,0.184761904761905,0.129671536251483
"S01001586",499,553,54,0.0976491862567812,0.357893773847521
"S01001587",770,867,97,0.111880046136102,0.305292599591188
"S01001588",723,860,137,0.159302325581395,0.176359338228774
"S01001589",740,822,82,0.0997566909975669,0.349622216604628
"S01001590",701,818,117,0.143031784841076,0.21362257363215
"S01001591",570,665,95,0.142857142857143,0.214058315601308
"S01001592",708,826,118,0.142857142857143,0.214058315601308
"S01001593",799,952,153,0.160714285714286,0.173419651561802
"S01001594",680,877,197,0.224629418472064,0.0785404153058499
"S01001595",657,808,151,0.186881188118812,0.126339771722365
"S01001596",744,886,142,0.160270880361174,0.174338030959164
"S01001597",700,903,203,0.224806201550388,0.078361528204942
"S01001598",611,662,51,0.0770392749244713,0.448572048264772
"S01001599",787,976,189,0.193647540983607,0.116211510715469
"S01001600",916,1140,224,0.196491228070175,0.112177620435912
"S01001601",693,880,187,0.2125,0.0917287815252124
"S01001602",586,669,83,0.12406576980568,0.265897945989198
"S01001603",823,948,125,0.131856540084388,0.243172790630713
"S01001604",637,728,91,0.125,0.263075576163828
"S01001605",584,644,60,0.093167701863354,0.376070958959315
"S01001606",499,566,67,0.118374558303887,0.28368811680788
"S01001607",946,1122,176,0.156862745098039,0.181544374000484
"S01001608",835,967,132,0.136504653567735,0.230462364847897
"S01001609",859,1010,151,0.149504950495049,0.198024032674257
"S01001610",532,700,168,0.24,0.0642888893233994
"S01001611",703,849,146,0.171967020023557,0.15152222804791
"S01001612",784,924,140,0.151515151515152,0.193393073125955
"S01001613",810,910,100,0.10989010989011,0.312202420326361
"S01001614",551,688,137,0.199127906976744,0.108550444497262
"S01001615",709,858,149,0.173659673659674,0.148453169176199
"S01001616",519,635,116,0.182677165354331,0.133025936663141
"S01001617",621,772,151,0.19559585492228,0.113433935124899
"S01001618",849,1031,182,0.176527643064985,0.143380552516079
"S01001619",679,768,89,0.115885416666667,0.291800171287728
"S01001620",758,880,122,0.138636363636364,0.224835733150507
"S01001621",716,791,75,0.0948166877370417,0.369288163775153
"S01001622",805,985,180,0.182741116751269,0.132921887206305
"S01001623",726,849,123,0.144876325088339,0.209068837573632
"S01001624",987,1121,134,0.119536128456735,0.279972516388235
"S01001625",700,837,137,0.163679808841099,0.167388578096101
"S01001626",765,857,92,0.107351225204201,0.321222629079196
"S01001627",677,752,75,0.0997340425531915,0.34971018499896
"S01001628",540,642,102,0.158878504672897,0.177250438207473
"S01001629",626,715,89,0.124475524475524,0.264656712863324
"S01001630",487,613,126,0.205546492659054,0.100157820852014
"S01001631",842,999,157,0.157157157157157,0.180911440933391
"S01001632",553,672,119,0.177083333333333,0.142415934026859
"S01001633",888,986,98,0.0993914807302231,0.351043154386111
"S01001634",717,885,168,0.189830508474576,0.121831291957073
"S01001635",683,790,107,0.135443037974684,0.233311488220271
"S01001636",542,616,74,0.12012987012987,0.278090237972389
"S01001637",692,784,92,0.11734693877551,0.287012173620079
"S01001638",773,952,179,0.188025210084034,0.12457343943075
"S01001639",626,720,94,0.130555555555556,0.246841608520636
"S01001640",641,760,119,0.156578947368421,0.182156373891657
"S01001641",566,654,88,0.134556574923547,0.235714787456877
"S01001642",880,991,111,0.112008072653885,0.304852791844617
"S01001643",695,847,152,0.179456906729634,0.138361079771263
"S01001644",630,784,154,0.196428571428571,0.112265125888392
"S01001645",830,989,159,0.160768452982811,0.173307759497493
"S01001646",547,617,70,0.113452188006483,0.299931184741335
"S01001647",610,717,107,0.149232914923291,0.198658336005439
"S01001648",743,817,74,0.0905752753977968,0.386961334644744
"S01001649",734,804,70,0.0870646766169154,0.402161147747501
"S01001650",825,963,138,0.143302180685358,0.212949494878614
"S01001651",815,986,171,0.17342799188641,0.148869914172814
"S01001652",735,887,152,0.171364148816234,0.152629046994637
"S01001653",596,732,136,0.185792349726776,0.128041804726385
"S01001654",563,629,66,0.104928457869634,0.330048295375316
"S01001655",557,649,92,0.14175654853621,0.216822817590073
"S01001656",897,1032,135,0.130813953488372,0.246108978324417
"S01001657",458,550,92,0.167272727272727,0.160334833486546
"S01001658",852,992,140,0.141129032258065,0.218413373162809
"S01001659",591,679,88,0.12960235640648,0.249561200439786
"S01001660",604,673,69,0.102526002971768,0.339014867002357
"S01001661",584,709,125,0.176304654442877,0.143769287119463
"S01001662",707,812,105,0.129310344827586,0.25039972383528
"S01001663",725,887,162,0.182638105975197,0.133089522651561
"S01001664",401,561,160,0.285204991087344,0.0348189053627887
"S01001665",699,832,133,0.159855769230769,0.175201772087909
"S01001666",551,672,121,0.180059523809524,0.137348290379273
"S01001667",678,790,112,0.141772151898734,0.216783401172172
"S01001668",740,891,151,0.169472502805836,0.156149341442997
"S01001669",590,772,182,0.235751295336788,0.0679746708123842
"S01001670",632,738,106,0.143631436314363,0.212132477727177
"S01001671",541,594,53,0.0892255892255892,0.392742772164453
"S01001672",562,613,51,0.0831973898858075,0.419525545244289
"S01001673",629,716,87,0.121508379888268,0.273763932929074
"S01001674",665,767,102,0.132985658409387,0.240028501338482
"S01001675",647,733,86,0.117326057298772,0.287080081118127
"S01001676",828,1018,190,0.18664047151277,0.126714288055432
"S01001677",771,875,104,0.118857142857143,0.282139082875212
"S01001678",903,1015,112,0.110344827586207,0.310611177974084
"S01001679",621,742,121,0.163072776280323,0.168607523281154
"S01001680",573,622,49,0.0787781350482315,0.440192230382463
"S01001681",623,710,87,0.122535211267606,0.270580801818436
"S01001682",624,707,83,0.117397454031117,0.286847955530612
"S01001683",670,767,97,0.126466753585398,0.258698784104504
"S01001684",680,736,56,0.0760869565217391,0.453222000784044
"S01001685",616,721,105,0.145631067961165,0.207230881541395
"S01001686",884,984,100,0.101626016260163,0.342429889595158
"S01001687",892,1075,183,0.170232558139535,0.154726214834168
"S01001688",749,930,181,0.194623655913978,0.114812372524438
"S01001689",687,754,67,0.0888594164456233,0.394324636729259
"S01001690",502,600,98,0.163333333333333,0.168083339312352
"S01001691",833,913,80,0.0876232201533406,0.399707446074102
"S01001692",614,710,96,0.135211267605634,0.233937704563298
"S01001693",606,845,239,0.282840236686391,0.0359881193561515
"S01001694",584,693,109,0.157287157287157,0.180632596614816
"S01001695",691,763,72,0.0943643512450852,0.371137718942741
"S01001696",717,806,89,0.110421836228288,0.310342417327345
"S01001697",760,871,111,0.12743972445465,0.255831709428124
"S01001698",481,558,77,0.137992831541219,0.226521158648467
"S01001699",627,724,97,0.133977900552486,0.237295633248536
"S01001700",911,1033,122,0.11810261374637,0.284564391575843
"S01001701",852,926,74,0.0799136069114471,0.434796541426046
"S01001702",909,997,88,0.0882647943831495,0.396905620679423
"S01001703",683,811,128,0.157829839704069,0.179472740616613
"S01001704",876,1013,137,0.135241855873643,0.233854972098438
"S01001705",530,643,113,0.175738724727838,0.144760130772201
"S01001706",747,827,80,0.0967351874244256,0.361535478799449
"S01001707",713,844,131,0.15521327014218,0.185127455621207
"S01001708",865,981,116,0.118246687054027,0.284099847661972
"S01001709",534,671,137,0.204172876304024,0.101903093592231
"S01001710",596,737,141,0.191316146540027,0.11961557128616
"S01001711",729,814,85,0.104422604422604,0.331918328129378
"S01001712",488,551,63,0.114337568058076,0.296949249169584
"S01001713",911,1019,108,0.105986261040236,0.326168434881773
"S01001714",683,746,63,0.0844504021447721,0.413826942294762
"S01001715",906,1029,123,0.119533527696793,0.279980786471855
"S01001716",745,837,92,0.109916367980884,0.31211033336707
"S01001717",718,831,113,0.135980746089049,0.231864470226831
"S01001718",463,531,68,0.128060263653484,0.25401812110964
"S01001719",744,837,93,0.111111111111111,0.307946147657439
"S01001720",626,771,145,0.188067444876783,0.124508657837433
"S01001721",580,692,112,0.161849710982659,0.171087780014471
"S01001722",704,812,108,0.133004926108374,0.239975165029948
"S01001723",675,749,74,0.0987983978638184,0.35336176159126
"S01001724",722,845,123,0.145562130177515,0.207398153846084
"S01001725",663,784,121,0.154336734693878,0.187057298186654
"S01001726",623,699,76,0.108726752503577,0.316306931539611
"S01001727",887,989,102,0.103134479271992,0.336723387887777
"S01001728",647,706,59,0.0835694050991501,0.417826322202508
"S01001729",933,1011,78,0.0771513353115727,0.448027716303796
"S01001730",590,665,75,0.112781954887218,0.302206404164121
"S01001731",626,655,29,0.0442748091603053,0.635814359803009
"S01001732",570,626,56,0.0894568690095847,0.391746589843229
"S01001733",636,802,166,0.206982543640898,0.0983620278470784
"S01001734",506,545,39,0.0715596330275229,0.475926783024227
"S01001735",488,542,54,0.0996309963099631,0.35011067651709
"S01001736",936,1083,147,0.135734072022161,0.232527285178481
"S01001737",586,639,53,0.0829420970266041,0.420695221035195
"S01001738",588,658,70,0.106382978723404,0.324723952575836
"S01001739",589,661,72,0.1089258698941,0.315600987201318
"S01001740",732,866,134,0.15473441108545,0.186179513192543
"S01001741",609,700,91,0.13,0.248423414191436
"S01001742",669,808,139,0.172029702970297,0.151407563232093
"S01001743",842,1009,167,0.165510406342914,0.163760536563185
"S01001744",588,658,70,0.106382978723404,0.324723952575836
"S01001745",881,948,67,0.0706751054852321,0.480480437985921
"S01001746",942,1069,127,0.118802619270346,0.282313714251398
"S01001747",813,935,122,0.13048128342246,0.24705255359157
"S01001748",609,668,59,0.0883233532934132,0.396650769885164
"S01001749",719,807,88,0.1090458488228,0.315176302739404
"S01001750",683,798,115,0.144110275689223,0.210949316865183
"S01001751",857,976,119,0.121926229508197,0.272464573685752
"S01001752",956,1040,84,0.0807692307692308,0.430770078903102
"S01001753",805,922,117,0.126898047722343,0.257424331225912
"S01001754",765,855,90,0.105263157894737,0.328816198631666
"S01001755",839,997,158,0.158475426278837,0.178101683719088
"S01001756",633,690,57,0.0826086956521739,0.422227185951826
"S01001757",708,813,105,0.129151291512915,0.25085751796448
"S01001758",691,782,91,0.116368286445013,0.29021038085895
"S01001759",465,646,181,0.280185758513932,0.0373425824832272
"S01001760",641,779,138,0.177150192554557,0.142300268148316
"S01001761",614,766,152,0.198433420365535,0.109495435455265
"S01001762",898,1044,146,0.139846743295019,0.221696266815383
"S01001763",803,873,70,0.0801832760595647,0.433523870828867
"S01001764",488,570,82,0.143859649122807,0.211567845431265
"S01001765",948,1059,111,0.104815864022663,0.330463708540562
"S01001766",656,728,72,0.0989010989010989,0.352959276570759
"S01001767",596,665,69,0.103759398496241,0.334384504887183
"S01001768",557,658,101,0.153495440729483,0.188926559411338
"S01001769",691,741,50,0.0674763832658569,0.497277024264866
"S01001770",496,582,86,0.147766323024055,0.202109588762422
"S01001771",843,968,125,0.129132231404959,0.25091242810301
"S01001772",490,577,87,0.150779896013865,0.195075473046727
"S01001773",903,1042,139,0.133397312859885,0.238891288834474
"S01001774",599,650,51,0.0784615384615385,0.441707382033591
"S01001775",729,774,45,0.0581395348837209,0.549370931745959
"S01001776",565,668,103,0.154191616766467,0.187378541169378
"S01001777",864,988,124,0.125506072874494,0.261557982556512
"S01001778",848,976,128,0.131147540983607,0.24516605899655
"S01001779",506,562,56,0.099644128113879,0.350059616529501
"S01001780",741,874,133,0.152173913043478,0.191896809185098
"S01001781",647,706,59,0.0835694050991501,0.417826322202508
"S01001782",889,987,98,0.099290780141844,0.351435867131667
"S01001783",570,681,111,0.162995594713656,0.16876307796017
"S01001784",550,622,72,0.115755627009646,0.29222882243369
"S01001785",657,710,53,0.0746478873239437,0.460330985056287
"S01001786",509,649,140,0.215716486902928,0.0880503031130209
"S01001787",610,675,65,0.0962962962962963,0.36329600470406
"S01001788",847,942,95,0.100849256900212,0.345402180871629
"S01001789",543,713,170,0.238429172510519,0.0656300896304862
"S01001790",712,839,127,0.151370679380215,0.193722617348223
"S01001791",691,807,116,0.143742255266419,0.211858126062309
"S01001792",702,776,74,0.095360824742268,0.367074240360753
"S01001793",795,919,124,0.134929270946681,0.234701666167408
"S01001794",863,986,123,0.12474645030426,0.263838887911143
"S01001795",776,999,223,0.223223223223223,0.0799764882280911
"S01001796",783,856,73,0.0852803738317757,0.410090750329461
"S01001797",659,752,93,0.123670212765957,0.267101139021771
"S01001798",876,959,83,0.086548488008342,0.404440827197315
"S01001799",935,1152,217,0.188368055555556,0.12404844307966
"S01001800",946,1063,117,0.110065851364064,0.311586561631425
"S01001801",870,1038,168,0.161849710982659,0.171087780014471
"S01001802",693,906,213,0.235099337748344,0.0685567733791857
"S01001803",819,1120,301,0.26875,0.0437178495234983
"S01001804",980,1147,167,0.145597210113339,0.207313019863144
"S01001805",752,838,86,0.102625298329356,0.338639972044266
"S01001806",602,695,93,0.133812949640288,0.237747996963957
"S01001807",817,868,51,0.0587557603686636,0.545787158953134
"S01001808",594,684,90,0.131578947368421,0.243951466173481
"S01001809",755,876,121,0.138127853881279,0.226166592371303
"S01001810",888,1022,134,0.131115459882583,0.245256598005815
"S01001811",679,762,83,0.108923884514436,0.315608019097354
"S01001812",528,616,88,0.142857142857143,0.214058315601308
"S01001813",668,767,99,0.129074315514993,0.251079343985737
"S01001814",567,896,329,0.3671875,0.0102979432055168
"S01001815",822,922,100,0.108459869848156,0.317255357567653
"S01001816",930,1160,230,0.198275862068966,0.1097108533959
"S01001817",651,737,86,0.116689280868385,0.289157863416904
"S01001818",733,817,84,0.10281517747858,0.337924111893287
"S01001819",965,1116,151,0.135304659498208,0.233685188893956
"S01001820",755,919,164,0.178454842219804,0.14006009043511
"S01001821",283,830,547,0.659036144578313,2.12365239361452e-05
"S01001822",948,1090,142,0.130275229357798,0.24763863071541
"S01001823",909,1161,252,0.217054263565891,0.0865598778362132
"S01001824",727,833,106,0.127250900360144,0.256385874698354
"S01001825",737,889,152,0.170978627671541,0.153340639061991
"S01001826",807,1109,302,0.272317403065825,0.0416312916728439
"S01001827",941,1117,176,0.157564905998209,0.180038134024554
"S01001828",757,839,82,0.0977353992848629,0.35755197947027
"S01001829",613,735,122,0.165986394557823,0.16282884951889
"S01001830",880,1009,129,0.12784935579782,0.254633218312775
"S01001831",721,799,78,0.097622027534418,0.358001506384178
"S01001832",637,737,100,0.135685210312076,0.232658779101656
"S01001833",896,1077,181,0.168059424326834,0.158826535847552
"S01001834",526,603,77,0.127694859038143,0.255084646998019
"S01001835",529,774,245,0.316537467700258,0.0222406314533932
"S01001836",685,793,108,0.136191677175284,0.23129904612505
"S01001837",857,1002,145,0.144710578842315,0.209474423528208
"S01001838",542,617,75,0.121555915721232,0.273615833300603
"S01001839",878,1034,156,0.150870406189555,0.194867660614018
"S01001840",678,814,136,0.167076167076167,0.160713696340319
"S01001841",677,786,109,0.138676844783715,0.224730090383035
"S01001842",727,886,159,0.179458239277652,0.138358832827297
"S01001843",694,829,135,0.162846803377563,0.169063322263915
"S01001844",1381,3011,1630,0.541348389239455,0.000411935509698671
"S01001845",816,908,92,0.101321585903084,0.343592046611111
"S01001846",871,1016,145,0.142716535433071,0.214409720457333
"S01001847",775,1002,227,0.226546906187625,0.0766195875399433
"S01001848",730,857,127,0.148191365227538,0.201103848618262
"S01001849",576,697,121,0.173601147776184,0.148558345242661
"S01001850",713,877,164,0.187001140250855,0.126153517655532
"S01001851",665,839,174,0.207389749702026,0.0978581147460073
"S01001852",768,853,85,0.0996483001172333,0.350043396060602
"S01001853",719,813,94,0.115621156211562,0.292673531462608
"S01001854",782,1826,1044,0.571741511500548,0.000207519923487414
"S01001855",656,849,193,0.227326266195524,0.0758510315302278
"S01001856",579,723,144,0.199170124481328,0.108493236336441
"S01001857",756,874,118,0.135011441647597,0.234478824746856
"S01001858",814,959,145,0.151199165797706,0.19411449981121
"S01001859",908,1033,125,0.121006776379477,0.275331100098805
"S01001860",932,1136,204,0.179577464788732,0.13815792750345
"S01001861",873,1124,251,0.223309608540925,0.0798875909012734
"S01001862",864,977,113,0.115660184237462,0.292544398996817
"S01001863",863,994,131,0.131790744466801,0.243357151424523
"S01001864",746,989,243,0.245702730030334,0.0596245835556575
"S01001865",607,798,191,0.239348370927318,0.0648422381994665
"S01001866",668,752,84,0.111702127659574,0.305904748734651
"S01001867",498,576,78,0.135416666666667,0.233382664256034
"S01001868",627,775,148,0.190967741935484,0.120131910327806
"S01001869",769,904,135,0.149336283185841,0.19841709790948
"S01001870",656,767,111,0.144719687092568,0.209452116996711
"S01001871",757,919,162,0.176278563656148,0.143814832945897
"S01001872",745,875,130,0.148571428571429,0.200208354984893
"S01001873",735,857,122,0.142357059509918,0.215310481223257
"S01001874",612,823,211,0.256379100850547,0.0517030150158211
"S01001875",843,918,75,0.0816993464052288,0.426431162426847
"S01001876",979,1135,156,0.137444933920705,0.227965067644834
"S01001877",911,1077,166,0.154131847725163,0.187510994311202
"S01001878",994,1178,184,0.156196943972835,0.182983082540194
"S01001879",595,757,162,0.214002642007926,0.089993441914979
"S01001880",662,838,176,0.210023866348449,0.0946541605151076
"S01001881",633,732,99,0.135245901639344,0.233844031438173
"S01001882",648,829,181,0.218335343787696,0.0851539411774877
"S01001883",516,621,105,0.169082125603865,0.156884852777402
"S01001884",906,1044,138,0.132183908045977,0.242257365533107
"S01001885",1017,1144,127,0.111013986013986,0.308282792770653
"S01001886",553,640,87,0.1359375,0.231980549703841
"S01001887",828,952,124,0.130252100840336,0.24770449292881
"S01001888",836,1046,210,0.200764818355641,0.106352065542763
"S01001889",525,635,110,0.173228346456693,0.149229877038721
"S01001890",807,972,165,0.169753086419753,0.155622611152527
"S01001891",604,711,107,0.150492264416315,0.195737203345621
"S01001892",660,895,235,0.262569832402235,0.0475564033927225
"S01001893",865,1067,202,0.189315838800375,0.122607455751082
"S01001894",649,822,173,0.210462287104623,0.0941301590706199
"S01001895",665,830,165,0.198795180722892,0.109002266722724
"S01001896",760,903,143,0.158361018826135,0.178343965774501
"S01001897",744,1007,263,0.261171797418074,0.048465717877759
"S01001898",591,707,116,0.164073550212164,0.166602176534036
"S01001899",729,859,130,0.151338766006985,0.193795480592026
"S01001900",783,879,96,0.109215017064846,0.314578378729922
"S01001901",880,1082,202,0.186691312384473,0.126635104707342
"S01001902",772,1042,270,0.259117082533589,0.0498305652649327
"S01001903",537,631,94,0.148969889064976,0.199273369607303
"S01001904",589,687,98,0.142649199417758,0.214578189824898
"S01001905",778,1031,253,0.245392822502425,0.0598700081219164
"S01001906",819,1056,237,0.224431818181818,0.0787408023123391
"S01001907",743,859,116,0.135040745052387,0.234399401955959
"S01001908",728,946,218,0.230443974630021,0.0728454497700389
"S01001909",611,769,158,0.205461638491547,0.100264849072478
"S01001910",691,843,152,0.180308422301305,0.136931929397843
"S01001911",710,810,100,0.123456790123457,0.267752354427952
"S01001912",736,858,122,0.142191142191142,0.215727377949114
"S01001913",734,1023,289,0.282502443792766,0.0361579884782987
"S01001914",543,641,98,0.152886115444618,0.190290891472847
"S01001915",784,909,125,0.137513751375138,0.227783254968757
"S01001916",624,955,331,0.346596858638743,0.0141844395561654
"S01001917",641,790,149,0.188607594936709,0.123682821017018
"S01001918",623,1014,391,0.38560157790927,0.00766480157887887
"S01001919",849,969,120,0.123839009287926,0.266587100989253
"S01001920",654,754,100,0.13262599469496,0.241026072786373
"S01001921",560,659,99,0.150227617602428,0.196347838242578
"S01001922",756,823,67,0.0814094775212637,0.427779139850553
"S01001923",686,831,145,0.174488567990373,0.146970752983311
"S01001924",624,787,163,0.207115628970775,0.0981970798839584
"S01001925",716,876,160,0.182648401826484,0.13307275905794
"S01001926",708,892,184,0.20627802690583,0.0992393778957292
"S01001927",788,974,186,0.190965092402464,0.120135844635131
"S01001928",794,1256,462,0.367834394904459,0.0101931550467573
"S01001929",704,790,86,0.108860759493671,0.315831671316402
"S01001930",553,899,346,0.384872080088988,0.00775629637877904
"S01001931",705,854,149,0.174473067915691,0.146998351027986
"S01001932",1089,1528,439,0.287303664921466,0.0338100065702063
"S01001933",858,974,116,0.119096509240246,0.281373575742306
"S01001934",693,841,148,0.175980975029727,0.144335243138267
"S01001935",643,777,134,0.172458172458172,0.150625860588897
"S01001936",853,1071,218,0.203548085901027,0.10270594983875
"S01001937",812,985,173,0.175634517766497,0.144943247445617
"S01001938",435,715,280,0.391608391608392,0.00694755752758337
"S01001939",409,689,280,0.406386066763425,0.00543301446105807
"S01001940",606,815,209,0.256441717791411,0.051659494746953
"S01001941",797,1060,263,0.24811320754717,0.0577463529959894
"S01001942",411,644,233,0.361801242236025,0.0112088109714709
"S01001943",556,667,111,0.166416791604198,0.161990511467981
"S01001944",592,871,279,0.320321469575201,0.0210395049646617
"S01001945",633,776,143,0.184278350515464,0.130442732442771
"S01001946",706,973,267,0.274409044193217,0.0404500076268485
"S01001947",708,943,235,0.249204665959703,0.0569135465692517
"S01001948",654,887,233,0.262683201803833,0.0474833427437009
"S01001949",557,763,206,0.269986893840105,0.0429839747247228
"S01001950",771,995,224,0.225125628140704,0.0780392295363127
"S01001951",735,875,140,0.16,0.174901228765981
"S01001952",651,869,218,0.250863060989643,0.0556688335152047
"S01001953",632,940,308,0.327659574468085,0.0188752297606414
"S01001954",468,543,75,0.138121546961326,0.226183143104178
"S01001955",749,858,109,0.127039627039627,0.257007204936521
"S01001956",713,840,127,0.151190476190476,0.194134373218528
"S01001957",725,859,134,0.155995343422584,0.183420734150205
"S01001958",717,990,273,0.275757575757576,0.0397044889739243
"S01001959",596,651,55,0.0844854070660522,0.413668747834463
"S01001960",698,1021,323,0.316356513222331,0.022299586260635
"S01001961",799,1067,268,0.251171508903468,0.0554400481632827
"S01001962",759,904,145,0.160398230088496,0.174073817719352
"S01001963",635,871,236,0.270952927669346,0.0424185386666699
"S01001964",694,876,182,0.207762557077626,0.0973988082245709
"S01001965",740,909,169,0.185918591859186,0.127843415568836
"S01001966",708,838,130,0.155131264916468,0.185307241259158
"S01001967",595,782,187,0.239130434782609,0.0650282589818964
"S01001968",680,938,258,0.275053304904051,0.0400922789394084
"S01001969",588,723,135,0.186721991701245,0.12658734400915
"S01001970",573,658,85,0.129179331306991,0.250776757965697
"S01001971",671,828,157,0.189613526570048,0.122157977527962
"S01001972",661,842,181,0.214964370546318,0.0888983458136074
"S01001973",651,760,109,0.143421052631579,0.212654199148383
"S01001974",584,1017,433,0.425762045231072,0.00389869213455396
"S01001975",671,975,304,0.311794871794872,0.0238330182036624
"S01001976",558,938,380,0.405117270788913,0.00555026354786658
"S01001977",713,827,114,0.137847642079807,0.226902981735723
"S01001978",496,822,326,0.396593673965937,0.00639880078631216
"S01001979",543,871,328,0.376578645235362,0.00886781748107829
"S01001980",545,824,279,0.338592233009709,0.0160211211970049
"S01001981",628,929,301,0.324004305705059,0.0199268796308277
"S01001982",477,625,148,0.2368,0.0670476587067647
"S01001983",551,909,358,0.393839383938394,0.0066969515394014
"S01001984",340,599,259,0.432387312186978,0.00347153019078963
"S01001985",696,880,184,0.209090909090909,0.0957779802786811
"S01001986",430,716,286,0.399441340782123,0.00610315405807785
"S01001987",459,1057,598,0.565752128666036,0.000238438830100735
"S01001988",723,872,149,0.170871559633028,0.15353879349974
"S01001989",817,961,144,0.149843912591051,0.197236228121525
"S01001990",610,1224,614,0.501633986928105,0.00094511394686244
"S01001991",732,871,139,0.159586681974742,0.175763730017222
"S01001992",704,1027,323,0.314508276533593,0.0229098452391559
"S01001993",612,889,277,0.311586051743532,0.0239054328490832
"S01001994",577,1068,491,0.459737827715356,0.0021185835929503
"S01001995",615,759,144,0.189723320158103,0.121992575105595
"S01001996",559,1185,626,0.528270042194093,0.000545675651207738
"S01001997",646,829,183,0.220747889022919,0.0825619371876111
"S01001998",654,794,140,0.17632241813602,0.143738285054395
"S01001999",376,997,621,0.622868605817452,5.82005201652576e-05
"S01002000",699,858,159,0.185314685314685,0.128794963087313
"S01002001",587,940,353,0.375531914893617,0.00901783898165417
"S01002002",399,937,538,0.574172892209178,0.000196034743147579
"S01002003",765,904,139,0.153761061946903,0.188334570846993
"S01002004",581,911,330,0.362239297475302,0.0111321116683017
"S01002005",748,846,98,0.115839243498818,0.291952600683244
"S01002006",860,996,136,0.136546184738956,0.230351544324503
"S01002007",727,1058,331,0.312854442344045,0.0234686134397419
"S01002008",628,1031,403,0.390882638215325,0.007030881600908
"S01002009",562,946,384,0.405919661733615,0.00547585313550744
"S01002010",337,651,314,0.482334869431644,0.00138193979458451
"S01002011",1000,1180,180,0.152542372881356,0.191064466913606
"S01002012",547,937,390,0.416221985058698,0.00459703017477779
"S01002013",599,963,364,0.377985462097612,0.0086697256106586
"S01002014",490,1032,542,0.525193798449612,0.000582322843933158
"S01002015",889,963,74,0.0768431983385254,0.449525919918892
"S01002016",394,654,260,0.397553516819572,0.00629774011656983
"S01002017",1048,1204,156,0.129568106312292,0.249659420010895
"S01002018",788,909,121,0.133113311331133,0.239675334783805
"S01002019",436,1042,606,0.581573896353167,0.000164508257797354
"S01002020",198,655,457,0.697709923664122,6.37145914535244e-06
"S01002021",887,1032,145,0.140503875968992,0.220008381127947
"S01002022",710,829,119,0.143546441495778,0.212343113860969
"S01002023",512,959,447,0.466110531803962,0.00188154035765104
"S01002024",539,881,342,0.388195232690125,0.00734731344493032
"S01002025",614,986,372,0.377281947261663,0.00876828307262389
"S01002026",695,786,91,0.115776081424936,0.292161230852628
"S01002027",582,1341,759,0.565995525727069,0.000237105740115971
"S01002028",581,4139,3558,0.859627929451558,2.97034612960362e-09
"S01002029",438,1000,562,0.562,0.000259860999801001
"S01002030",565,932,367,0.393776824034335,0.00670386646040438
"S01002031",534,791,257,0.324905183312263,0.0196629074608333
"S01002032",541,936,395,0.422008547008547,0.00416115759116499
"S01002033",553,942,389,0.412951167728238,0.0048611865219885
"S01002034",532,1259,727,0.577442414614774,0.000181492641636835
"S01002035",714,822,108,0.131386861313869,0.24449159983366
"S01002036",603,1026,423,0.412280701754386,0.00491699213534858
"S01002037",427,873,446,0.510882016036655,0.000783675578560989
"S01002038",388,901,513,0.569367369589345,0.000219315510034319
"S01002039",552,673,121,0.179791976225854,0.137797118181012
"S01002040",382,655,273,0.416793893129771,0.00455219260771311
"S01002041",656,1133,477,0.421006178287732,0.00423388731541139
"S01002042",845,997,152,0.152457372116349,0.191256192819029
"S01002043",739,822,83,0.100973236009732,0.34492621959082
"S01002044",602,800,198,0.2475,0.0582190403719335
"S01002045",649,946,297,0.313953488372093,0.0230959379444484
"S01002046",439,685,246,0.359124087591241,0.0116879807459433
"S01002047",549,922,373,0.404555314533623,0.0056029175800748
"S01002048",450,1111,661,0.594959495949595,0.000118845994276441
"S01002049",667,1411,744,0.527285613040397,0.000557170612200852
"S01002050",675,752,77,0.102393617021277,0.33951527825466
"S01002051",762,871,109,0.125143513203215,0.262644410847403
"S01002052",520,900,380,0.422222222222222,0.00414579994987929
"S01002053",391,928,537,0.578663793103448,0.000176314411448327
"S01002054",428,944,516,0.546610169491525,0.000367043677166901
"S01002055",811,1005,194,0.193034825870647,0.117097581277737
"S01002056",879,982,103,0.104887983706721,0.330197570002165
"S01002057",773,918,145,0.157952069716776,0.179212429404459
"S01002058",479,788,309,0.392131979695431,0.00688799715792271
"S01002059",494,843,349,0.413997627520759,0.00477522393799675
"S01002060",418,928,510,0.549568965517241,0.000343781938047963
"S01002061",458,815,357,0.438036809815951,0.00314107779460932
"S01002062",572,688,116,0.168604651162791,0.157788702718927
"S01002063",517,1294,777,0.600463678516229,0.00010364841557243
"S01002064",648,977,329,0.336745138178096,0.0164742033160811
"S01002065",562,939,377,0.401490947816826,0.00589803347385977
"S01002066",439,842,403,0.478622327790974,0.00148430888602901
"S01002067",708,903,195,0.215946843853821,0.0877920264633978
"S01002068",573,1063,490,0.460959548447789,0.00207115963944672
"S01002069",519,664,145,0.218373493975904,0.0851123897851374
"S01002070",466,768,302,0.393229166666667,0.0067646754713805
"S01002071",400,808,408,0.504950495049505,0.000884069291692366
"S01002072",949,1263,314,0.2486144101346,0.0573625723832348
"S01002073",487,767,280,0.365058670143416,0.0106496656376363
"S01002074",644,701,57,0.0813124108416548,0.428231385437219
"S01002075",673,1007,334,0.331678252234359,0.0177768962057908
"S01002076",541,1008,467,0.463293650793651,0.0019832037272196
"S01002077",754,904,150,0.165929203539823,0.162940541003645
"S01002078",884,1035,151,0.145893719806763,0.206594688729017
"S01002079",545,909,364,0.4004400440044,0.00600241737451461
"S01002080",931,1052,121,0.115019011406844,0.294672366991516
"S01002081",486,805,319,0.396273291925466,0.00643285687617195
"S01002082",689,944,255,0.270127118644068,0.0429014801497397
"S01002083",505,569,64,0.112478031634446,0.303243232338605
"S01002084",291,605,314,0.51900826446281,0.000662790299209812
"S01002085",304,932,628,0.67381974248927,1.36325378623105e-05
"S01002086",343,723,380,0.525587828492393,0.000577508296216735
"S01002087",694,1297,603,0.464919043947571,0.00192395514947041
"S01002088",847,959,112,0.116788321167883,0.288833811693935
"S01002089",934,1052,118,0.112167300380228,0.304306594675765
"S01002090",992,1177,185,0.157179269328802,0.180863984012724
"S01002091",560,960,400,0.416666666666667,0.00456213297416992
"S01002092",879,1062,183,0.172316384180791,0.150884137024862
"S01002093",556,897,341,0.38015607580825,0.00837188945948939
"S01002094",675,826,151,0.182808716707022,0.132811981152901
"S01002095",486,619,133,0.21486268174475,0.0890135665392879
"S01002096",774,875,101,0.115428571428571,0.293311490346382
"S01002097",756,835,79,0.0946107784431138,0.370129073561595
"S01002098",678,741,63,0.0850202429149798,0.411258473213183
"S01002099",622,1027,405,0.394352482960078,0.00664047905078405
"S01002100",548,669,121,0.180866965620329,0.136001721967279
"S01002101",733,983,250,0.254323499491353,0.0531501590031947
"S01002102",566,743,177,0.238223418573351,0.0658076184692434
"S01002103",706,810,104,0.128395061728395,0.25304445310095
"S01002104",795,1372,577,0.420553935860058,0.0042670739838557
"S01002105",888,1115,227,0.203587443946188,0.102655207206957
"S01002106",496,1167,671,0.574978577549272,0.000192357092681106
"S01002107",527,582,55,0.0945017182130584,0.370575160711541
"S01002108",485,1428,943,0.660364145658263,2.04237418096881e-05
"S01002109",520,1073,553,0.515377446411929,0.000714555911842602
"S01002110",602,760,158,0.207894736842105,0.0972364264780304
"S01002111",959,1086,127,0.116942909760589,0.2883286637015
"S01002112",955,1154,199,0.172443674176776,0.150652251862628
"S01002113",713,796,83,0.10427135678392,0.332479307368545
"S01002114",668,768,100,0.130208333333333,0.247829171166007
"S01002115",783,1234,451,0.36547811993517,0.0105795214542176
"S01002116",765,920,155,0.168478260869565,0.158028740252381
"S01002117",421,758,337,0.444591029023747,0.00279337281334641
"S01002118",537,1227,690,0.562347188264059,0.000257808498630182
"S01002119",556,635,79,0.124409448818898,0.264856516600668
"S01002120",712,819,107,0.130647130647131,0.246581743359014
"S01002121",658,736,78,0.105978260869565,0.326197623563249
"S01002122",905,1049,144,0.137273593898951,0.228418307961354
"S01002123",968,1483,515,0.347269049224545,0.0140391903614092
"S01002124",720,798,78,0.0977443609022556,0.3575164677055
"S01002125",967,1214,247,0.203459637561779,0.102820064847904
"S01002126",624,702,78,0.111111111111111,0.307946147657439
"S01002127",660,787,127,0.161372299872935,0.172064799133411
"S01002128",470,991,521,0.525731584258325,0.000575760722294764
"S01002129",577,988,411,0.415991902834008,0.00461518044370331
"S01002130",630,681,51,0.0748898678414097,0.459128630408915
"S01002131",473,876,403,0.460045662100457,0.00210654308279052
"S01002132",730,858,128,0.149184149184149,0.198772235802256
"S01002133",849,1245,396,0.318072289156626,0.0217462005106127
"S01002134",588,649,61,0.0939907550077042,0.372671595544087
"S01002135",831,910,79,0.0868131868131868,0.403270370858577
"S01002136",531,824,293,0.355582524271845,0.0123501744972581
"S01002137",824,955,131,0.13717277486911,0.228685380188785
"S01002138",561,737,176,0.238805970149254,0.0653060977396646
"S01002139",659,732,73,0.0997267759562842,0.349738413271195
"S01002140",796,986,190,0.192697768762677,0.117587600431708
"S01002141",605,788,183,0.232233502538071,0.0711691160314291
"S01002142",995,1121,126,0.112399643175736,0.303511171842401
"S01002143",698,810,112,0.138271604938272,0.225789653680353
"S01002144",675,770,95,0.123376623376623,0.267997335750011
"S01002145",763,1131,368,0.325375773651636,0.0195262718011176
"S01002146",760,1088,328,0.301470588235294,0.0276596683970466
"S01002147",882,1040,158,0.151923076923077,0.192465307690341
"S01002148",807,930,123,0.132258064516129,0.242050431774719
"S01002149",889,1120,231,0.20625,0.0992744256176041
"S01002150",582,799,217,0.271589486858573,0.0420496178603692
"S01002151",776,1258,482,0.383147853736089,0.00797647120051228
"S01002152",675,907,232,0.255788313120176,0.0521152538717941
"S01002153",516,562,46,0.0818505338078292,0.425729613584765
"S01002154",816,984,168,0.170731707317073,0.153797970011677
"S01002155",893,1132,239,0.21113074204947,0.0933362440360917
"S01002156",462,901,439,0.487236403995561,0.00125652705991682
"S01002157",684,880,196,0.222727272727273,0.0804885855922017
"S01002158",642,873,231,0.264604810996564,0.0462602359581712
"S01002159",591,852,261,0.306338028169014,0.0257916342314304
"S01002160",599,916,317,0.346069868995633,0.0142992575079281
"S01002161",390,904,514,0.56858407079646,0.000223337559188944
"S01002162",916,1118,202,0.180679785330948,0.136312819600182
"S01002163",749,1184,435,0.367398648648649,0.0102636339142976
"S01002164",815,904,89,0.0984513274336283,0.354724987966175
"S01002165",887,1047,160,0.152817574021012,0.190444915138194
"S01002166",537,1037,500,0.482160077145612,0.00138661308159173
"S01002167",605,722,117,0.162049861495845,0.170679660695749
"S01002168",764,1199,435,0.362802335279399,0.0110342229499817
"S01002169",596,909,313,0.344334433443344,0.0146833031465861
"S01002170",794,928,134,0.144396551724138,0.210244799475574
"S01002171",588,656,68,0.103658536585366,0.334761008085343
"S01002172",691,794,103,0.129722921914358,0.249215729321117
"S01002173",849,1067,218,0.204311152764761,0.101726173424003
"S01002174",747,1070,323,0.301869158878505,0.0275022509967743
"S01002175",805,1104,299,0.270833333333333,0.0424881742724212
"S01002176",752,842,90,0.106888361045131,0.322892153074169
"S01002177",587,902,315,0.349223946784922,0.0136243451449305
"S01002178",651,1067,416,0.389878163074039,0.00714768971743788
"S01002179",651,704,53,0.0752840909090909,0.457175863936624
"S01002180",338,644,306,0.475155279503106,0.00158601879350737
"S01002181",658,850,192,0.225882352941176,0.0772804565319767
"S01002182",549,966,417,0.43167701863354,0.00351521732753232
"S01002183",673,996,323,0.32429718875502,0.0198407122236814
"S01002184",754,846,92,0.108747044917258,0.316234922494812
"S01002185",692,880,188,0.213636363636364,0.0904136960080503
"S01002186",557,854,297,0.347775175644028,0.0139307097874881
"S01002187",605,1088,483,0.443933823529412,0.00282660285254895
"S01002188",693,834,141,0.169064748201439,0.156917665981801
"S01002189",622,932,310,0.332618025751073,0.0175284988053345
"S01002190",569,926,357,0.385529157667387,0.00767384101139951
"S01002191",842,998,156,0.156312625250501,0.182732376377853
"S01002192",810,904,94,0.103982300884956,0.333553793342191
"S01002193",852,998,146,0.146292585170341,0.205631921997065
"S01002194",746,851,105,0.123384253819036,0.267974009220121
"S01002195",722,1138,416,0.365553602811951,0.0105669427649373
"S01002196",617,726,109,0.150137741046832,0.196555605277137
"S01002197",450,654,204,0.311926605504587,0.0237874371875606
"S01002198",665,968,303,0.31301652892562,0.0234133134815547
"S01002199",556,1001,445,0.444555444555445,0.00279516301398528
"S01002200",704,862,158,0.183294663573086,0.132024318136552
"S01002201",618,1082,464,0.428835489833641,0.00369498043537639
"S01002202",415,868,453,0.521889400921659,0.000624142441321318
"S01002203",414,608,194,0.319078947368421,0.0214273083057865
"S01002204",645,786,141,0.179389312977099,0.138475099525983
"S01002205",602,891,289,0.324354657687991,0.0198238440348072
"S01002206",448,621,173,0.278582930756844,0.0381824804633461
"S01002207",752,906,154,0.169977924944812,0.155201683975948
"S01002208",384,642,258,0.401869158878505,0.00586086830753785
"S01002209",738,1052,314,0.298479087452471,0.0288673036198701
"S01002210",496,709,213,0.300423131170663,0.0280772399208687
"S01002211",565,681,116,0.170337738619677,0.154530197289476
"S01002212",929,1085,156,0.143778801843318,0.211767718677489
"S01002213",739,895,156,0.174301675977654,0.147303827234705
"S01002214",571,952,381,0.400210084033613,0.00602547929728088
"S01002215",900,1066,166,0.155722326454034,0.184014924359168
"S01002216",642,866,224,0.258660508083141,0.0501385027179727
"S01002217",644,1052,408,0.387832699619772,0.00739096720802668
"S01002218",380,668,288,0.431137724550898,0.00354871679100594
"S01002219",604,712,108,0.151685393258427,0.193005395449404
"S01002220",748,848,100,0.117924528301887,0.285139547506579
"S01002221",637,898,261,0.290645879732739,0.032257518623483
"S01002222",793,902,109,0.120842572062084,0.275845877448678
"S01002223",689,754,65,0.0862068965517241,0.405955809076743
"S01002224",690,797,107,0.134253450439147,0.236541688941857
"S01002225",542,826,284,0.343825665859564,0.0147976377740388
"S01002226",814,1185,371,0.313080168776371,0.0233916332104175
"S01002227",761,902,141,0.156319290465632,0.182717940849497
"S01002228",940,1018,78,0.0766208251473477,0.450609927962794
"S01002229",720,818,98,0.119804400977995,0.279120624162466
"S01002230",826,1209,383,0.316790736145575,0.0221583523802685
"S01002231",888,1261,373,0.295796986518636,0.029990160641677
"S01002232",738,806,68,0.0843672456575682,0.414202961937848
"S01002233",766,1083,317,0.292705447830102,0.0313330830679886
"S01002234",634,888,254,0.286036036036036,0.0344162003329294
"S01002235",775,1118,343,0.306797853309481,0.0256211718573297
"S01002236",854,981,127,0.129459734964322,0.249970427587183
"S01002237",969,1205,236,0.195850622406639,0.113075183552347
"S01002238",511,619,108,0.174474959612278,0.146994982592618
"S01002239",818,1050,232,0.220952380952381,0.0823455331994142
"S01002240",625,863,238,0.275782155272306,0.0396910160260782
"S01002241",821,955,134,0.140314136125654,0.220494547942998
"S01002242",734,853,119,0.139507620164127,0.222571876571468
"S01002243",657,856,199,0.232476635514019,0.0709440616487254
"S01002244",618,811,193,0.237977805178792,0.066020104706474
"S01002245",716,1087,371,0.34130634774609,0.0153756959448906
"S01002246",724,1010,286,0.283168316831683,0.0358238224792596
"S01002247",844,980,136,0.138775510204082,0.224472792498711
"S01002248",987,1289,302,0.234290147401086,0.0692854996418769
"S01002249",663,870,207,0.237931034482759,0.0660606371115962
"S01002250",848,1074,226,0.210428305400372,0.0941706805399596
"S01002251",773,886,113,0.127539503386005,0.255539311484779
"S01002252",514,683,169,0.247437774524158,0.0582672005824608
"S01002253",943,1059,116,0.109537299338999,0.31344209852118
"S01002254",644,969,325,0.335397316821465,0.0168120589089333
"S01002255",843,1170,327,0.279487179487179,0.0377065787198349
"S01002256",621,869,248,0.285385500575374,0.0347310759141061
"S01002257",668,767,99,0.129074315514993,0.251079343985737
"S01002258",564,904,340,0.376106194690265,0.00893525055368612
"S01002259",482,608,126,0.207236842105263,0.0980470631703858
"S01002260",783,945,162,0.171428571428571,0.152510426461968
"S01002261",948,1087,139,0.1278748850046,0.254558693023783
"S01002262",756,835,79,0.0946107784431138,0.370129073561595
"S01002263",733,861,128,0.148664343786295,0.199989977655788
"S01002264",765,949,184,0.193888303477345,0.115864989673923
"S01002265",942,1106,164,0.148282097649186,0.200889740721269
"S01002266",564,729,165,0.226337448559671,0.0768273328925835
"S01002267",829,1103,274,0.248413417951043,0.0575161994563188
"S01002268",665,771,106,0.137483787289235,0.227862402713749
"S01002269",778,1045,267,0.255502392344498,0.052315823441647
"S01002270",711,1092,381,0.348901098901099,0.0136920861681088
"S01002271",773,925,152,0.164324324324324,0.166103051802081
"S01002272",513,630,117,0.185714285714286,0.12816462070165
"S01002273",667,918,251,0.273420479302832,0.041004500621397
"S01002274",663,883,220,0.249150622876557,0.0569545268454145
"S01002275",761,1030,269,0.261165048543689,0.0484701451923397
"S01002276",756,894,138,0.154362416107383,0.187000499699775
"S01002277",694,860,166,0.193023255813953,0.117114371507526
"S01002278",958,1208,250,0.206953642384106,0.0983978814398041
"S01002279",832,1081,249,0.230342275670675,0.0729417743178323
"S01002280",718,885,167,0.188700564971751,0.123541177232764
"S01002281",603,824,221,0.268203883495146,0.0440454452354279
"S01002282",806,1089,283,0.259871441689624,0.0493255141077892
"S01002283",682,793,111,0.139974779319042,0.22136648718037
"S01002284",939,1114,175,0.157091561938959,0.181052286672468
"S01002285",667,869,202,0.232451093210587,0.0709676745603876
"S01002286",665,880,215,0.244318181818182,0.0607281053087401
"S01002287",681,856,175,0.204439252336449,0.101562520976293
"S01002288",515,916,401,0.437772925764192,0.00315585872764525
"S01002289",684,877,193,0.220068415051311,0.0832846727369611
"S01002290",625,883,258,0.292185730464326,0.0315640801615438
"S01002291",720,918,198,0.215686274509804,0.0880842279823248
"S01002292",665,923,258,0.279523293607801,0.037687683388754
"S01002293",821,942,121,0.128450106157113,0.252884693454737
"S01002294",531,674,143,0.212166172106825,0.0921183701652866
"S01002295",685,811,126,0.155363748458693,0.184797960048906
"S01002296",630,812,182,0.224137931034483,0.0790396852460788
"S01002297",880,976,96,0.0983606557377049,0.35508190798263
"S01002298",659,815,156,0.191411042944785,0.119475280424207
"S01002299",788,888,100,0.112612612612613,0.302783717693579
"S01002300",734,858,124,0.144522144522145,0.209936387937799
"S01002301",670,914,244,0.266958424507659,0.0448008309970747
"S01002302",857,1031,174,0.168768186226964,0.157478607680562
"S01002303",783,896,113,0.126116071428571,0.259739215186105
"S01002304",610,1000,390,0.39,0.00713342911662882
"S01002305",712,963,251,0.260643821391485,0.0488131759367858
"S01002306",686,882,196,0.222222222222222,0.0810131102224121
"S01002307",511,865,354,0.409248554913295,0.00517663955761055
"S01002308",827,1050,223,0.212380952380952,0.0918675437432302
"S01002309",679,820,141,0.171951219512195,0.15155114397681
"S01002310",729,954,225,0.235849056603774,0.0678877689181872
"S01002311",579,916,337,0.367903930131004,0.0101819486063894
"S01002312",598,743,145,0.195154777927322,0.114057461689381
"S01002313",677,791,114,0.144121365360303,0.210921985982731
"S01002314",731,913,182,0.19934282584885,0.108259494336195
"S01002315",530,603,73,0.12106135986733,0.275160173492327
"S01002316",689,790,101,0.127848101265823,0.254636881069773
"S01002317",641,1011,370,0.365974282888229,0.0104970856131512
"S01002318",721,974,253,0.259753593429158,0.0494041098168405
"S01002319",986,1196,210,0.175585284280936,0.145029835003895
"S01002320",567,688,121,0.175872093023256,0.144526074396727
"S01002321",759,1024,265,0.2587890625,0.0500516262101115
"S01002322",590,737,147,0.199457259158752,0.10810486476526
"S01002323",715,865,150,0.173410404624277,0.148901592778933
"S01002324",684,852,168,0.197183098591549,0.111215436198185
"S01002325",529,652,123,0.188650306748466,0.12361772962427
"S01002326",729,894,165,0.184563758389262,0.129987052238969
"S01002327",652,910,258,0.283516483516484,0.0356502052119514
"S01002328",696,834,138,0.165467625899281,0.163844508428913
"S01002329",634,796,162,0.203517587939698,0.102745285068323
"S01002330",745,849,104,0.122497055359246,0.270698484908252
"S01002331",661,742,81,0.109164420485175,0.314757104900697
"S01002332",905,998,93,0.093186372745491,0.375993536418857
"S01002333",794,877,83,0.0946408209806157,0.370006276027783
"S01002334",758,894,136,0.152125279642058,0.192006914359941
"S01002335",897,1085,188,0.173271889400922,0.149151301915709
"S01002336",959,1095,136,0.124200913242009,0.265487990280505
"S01002337",918,1051,133,0.126546146527117,0.258463756309308
"S01002338",511,637,126,0.197802197802198,0.110360758832281
"S01002339",585,683,98,0.143484626647145,0.212496423066125
"S01002340",512,561,49,0.0873440285204991,0.4009322555073
"S01002341",534,578,44,0.0761245674740484,0.453037535493912
"S01002342",595,679,84,0.123711340206186,0.266975811016249
"S01002343",747,825,78,0.0945454545454545,0.370396208675927
"S01002344",507,585,78,0.133333333333333,0.2390677160551
"S01002345",640,781,141,0.180537772087068,0.136549275768405
"S01002346",867,976,109,0.111680327868852,0.305979829360325
"S01002347",706,758,52,0.0686015831134565,0.491309265178131
"S01002348",914,1014,100,0.0986193293885602,0.354064518441722
"S01002349",984,1064,80,0.075187969924812,0.457651304605487
"S01002350",889,1014,125,0.1232741617357,0.268310741653364
"S01002351",613,679,66,0.0972017673048601,0.359672308502409
"S01002352",798,922,124,0.134490238611714,0.235895525373444
"S01002353",716,805,89,0.11055900621118,0.309864211594557
"S01002354",724,857,133,0.155192532088681,0.185172906231103
"S01002355",800,972,172,0.176954732510288,0.14263865027569
"S01002356",703,864,161,0.186342592592593,0.127179122869141
"S01002357",642,771,129,0.167315175097276,0.160253122413159
"S01002358",571,648,77,0.118827160493827,0.282235100130642
"S01002359",859,1017,158,0.155358898721731,0.18480857106226
"S01002360",615,783,168,0.21455938697318,0.0893580200168644
"S01002361",569,647,78,0.120556414219474,0.276745047228818
"S01002362",643,740,97,0.131081081081081,0.245353654966982
"S01002363",845,1020,175,0.17156862745098,0.15225282931555
"S01002364",673,826,153,0.185230024213075,0.128928867844454
"S01002365",521,591,70,0.11844331641286,0.283466945624989
"S01002366",513,599,86,0.143572621035058,0.212278215067182
"S01002367",818,945,127,0.134391534391534,0.236164682782789
"S01002368",832,904,72,0.079646017699115,0.436062718717232
"S01002369",503,558,55,0.0985663082437276,0.35427284192464
"S01002370",683,763,80,0.104849279161206,0.330340374854361
"S01002371",624,695,71,0.102158273381295,0.340406505218243
"S01002372",771,840,69,0.0821428571428571,0.4243761024975
"S01002373",604,650,46,0.0707692307692308,0.479994012292477
"S01002374",680,755,75,0.0993377483443709,0.351252651085347
"S01002375",853,947,94,0.0992608236536431,0.351552767902197
"S01002376",826,914,88,0.0962800875273523,0.363361170490971
"S01002377",799,889,90,0.101237345331834,0.343914259788486
"S01002378",524,604,80,0.132450331125828,0.241514652189523
"S01002379",890,1011,121,0.119683481701286,0.279504310885877
"S01002380",661,739,78,0.105548037889039,0.327770762103642
"S01002381",765,885,120,0.135593220338983,0.232906519026958
"S01002382",625,716,91,0.127094972067039,0.256844310790924
"S01002383",523,591,68,0.115059221658206,0.294538506177131
"S01002384",522,583,61,0.104631217838765,0.331145976344185
"S01002385",801,875,74,0.0845714285714286,0.413280230090421
"S01002386",898,1079,181,0.167747914735867,0.159422244716839
"S01002387",530,674,144,0.213649851632047,0.0903981891183419
"S01002388",786,890,104,0.11685393258427,0.288619316549924
"S01002389",693,806,113,0.140198511166253,0.220791285507733
"S01002390",645,771,126,0.163424124513619,0.167901032121926
"S01002391",843,930,87,0.0935483870967742,0.37449520439732
"S01002392",860,1107,247,0.223125564588979,0.0800770938986286
"S01002393",481,551,70,0.127041742286751,0.257000977531013
"S01002394",631,686,55,0.0801749271137026,0.433563222311346
"S01002395",728,807,79,0.0978934324659232,0.356926214465871
"S01002396",714,779,65,0.0834403080872914,0.41841528481602
"S01002397",885,1335,450,0.337078651685393,0.0163915510256844
"S01002398",788,907,119,0.131201764057332,0.245013099487069
"S01002399",959,1091,132,0.120989917506874,0.275383912480767
"S01002400",832,946,114,0.120507399577167,0.276899326164261
"S01002401",843,1023,180,0.175953079178886,0.144384112978928
"S01002402",821,959,138,0.143899895724713,0.21146840979771
"S01002403",706,840,134,0.15952380952381,0.17589526550369
"S01002404",891,1065,174,0.163380281690141,0.167989045556246
"S01002405",738,851,113,0.132784958871915,0.24058470691849
"S01002406",736,848,112,0.132075471698113,0.242560243990708
"S01002407",759,860,101,0.117441860465116,0.286703666220786
"S01002408",841,953,112,0.117523609653725,0.28643821033731
"S01002409",645,786,141,0.179389312977099,0.138475099525983
"S01002410",509,591,82,0.138747884940778,0.224544806419003
"S01002411",631,728,97,0.133241758241758,0.239320443677094
"S01002412",933,1101,168,0.152588555858311,0.190960370118687
"S01002413",624,753,129,0.171314741035857,0.152720077163325
"S01002414",585,663,78,0.117647058823529,0.286037765539156
"S01002415",727,835,108,0.129341317365269,0.250310664852172
"S01002416",505,586,81,0.138225255972696,0.225911126411864
"S01002417",658,747,89,0.119143239625167,0.281224347622945
"S01002418",897,997,100,0.100300902708124,0.347514433693786
"S01002419",499,577,78,0.135181975736568,0.234016955331969
"S01002420",662,767,105,0.136897001303781,0.229417347880334
"S01002421",826,952,126,0.132352941176471,0.241785910264515
"S01002422",556,656,100,0.152439024390244,0.191297600271497
"S01002423",665,767,102,0.132985658409387,0.240028501338482
"S01002424",830,940,110,0.117021276595745,0.288072888806311
"S01002425",753,850,97,0.114117647058824,0.297687435573398
"S01002426",543,710,167,0.235211267605634,0.0684565185460411
"S01002427",777,844,67,0.0793838862559242,0.437306287667119
"S01002428",493,565,72,0.127433628318584,0.255849583653978
"S01002429",662,742,80,0.107816711590297,0.319551486096973
"S01002430",475,640,165,0.2578125,0.0507149914273103
"S01002431",691,811,120,0.147965474722565,0.201637791306068
"S01002432",666,758,92,0.121372031662269,0.274189131156127
"S01002433",508,582,74,0.127147766323024,0.256689010799254
"S01002434",863,964,101,0.104771784232365,0.330626468341418
"S01002435",658,763,105,0.137614678899083,0.22751684495104
"S01002436",747,842,95,0.112826603325416,0.302054355985767
"S01002437",451,564,113,0.200354609929078,0.10689918125575
"S01002438",657,753,96,0.127490039840637,0.25568422469982
"S01002439",752,870,118,0.135632183908046,0.232801556537888
"S01002440",824,1027,203,0.197663096397274,0.11055227420137
"S01002441",611,665,54,0.081203007518797,0.42874162473327
"S01002442",464,570,106,0.185964912280702,0.127770692560699
"S01002443",681,741,60,0.0809716599190283,0.429822394585182
"S01002444",484,572,88,0.153846153846154,0.188145280374965
"S01002445",694,808,114,0.141089108910891,0.21851492062975
"S01002446",736,872,136,0.155963302752294,0.183490377454776
"S01002447",681,785,104,0.132484076433121,0.241420726042819
"S01002448",524,626,102,0.162939297124601,0.168876623725937
"S01002449",456,564,108,0.191489361702128,0.119359608820915
"S01002450",637,783,146,0.186462324393359,0.126992099364576
"S01002451",1040,1167,127,0.108826049700086,0.315954709033289
"S01002452",537,589,52,0.0882852292020374,0.396816670769004
"S01002453",751,851,100,0.117508813160987,0.286486241091953
"S01002454",762,851,89,0.104582843713279,0.331324928217822
"S01002455",591,659,68,0.103186646433991,0.336527580311254
"S01002456",926,1087,161,0.148114075436983,0.201286396924922
"S01002457",788,850,62,0.0729411764705882,0.468892102206459
"S01002458",798,961,163,0.169614984391259,0.155881665322758
"S01002459",501,675,174,0.257777777777778,0.0507387227347254
"S01002460",798,908,110,0.121145374449339,0.274897270887743
"S01002461",380,486,106,0.218106995884774,0.0854030288831604
"S01002462",575,742,167,0.225067385444744,0.0780979068259173
"S01002463",922,1122,200,0.17825311942959,0.140404375231215
"S01002464",511,581,70,0.120481927710843,0.276979532204856
"S01002465",569,727,158,0.217331499312242,0.0862538631376574
"S01002466",952,1050,98,0.0933333333333333,0.375384635653299
"S01002467",474,544,70,0.128676470588235,0.252228652516605
"S01002468",553,664,111,0.167168674698795,0.16053529090714
"S01002469",613,695,82,0.117985611510791,0.284942151563633
"S01002470",848,989,141,0.142568250758342,0.214780874638342
"S01002471",543,582,39,0.0670103092783505,0.499768005130734
"S01002472",513,669,156,0.233183856502242,0.0702930638827392
"S01002473",764,1014,250,0.2465483234714,0.0589595331126419
"S01002474",436,645,209,0.324031007751938,0.0199190098483867
"S01002475",501,611,110,0.180032733224223,0.13739317390764
"S01002476",747,903,156,0.172757475083056,0.150081967694151
"S01002477",804,881,77,0.0874006810442679,0.400683448934634
"S01002478",931,1061,130,0.122525918944392,0.270609457601794
"S01002479",673,816,143,0.175245098039216,0.145629398155248
"S01002480",512,600,88,0.146666666666667,0.204732649090523
"S01002481",943,1041,98,0.0941402497598463,0.372057130527032
"S01002482",766,950,184,0.193684210526316,0.116158673386695
"S01002483",630,804,174,0.216417910447761,0.0872659874065705
"S01002484",791,914,123,0.134573304157549,0.235669227172683
"S01002485",826,964,138,0.143153526970954,0.213319292280942
"S01002486",515,628,113,0.179936305732484,0.137554832707026
"S01002487",480,549,69,0.12568306010929,0.261029101969635
"S01002488",608,745,137,0.183892617449664,0.131060875645828
"S01002489",502,605,103,0.170247933884298,0.154697546169917
"S01002490",597,641,44,0.0686427457098284,0.491092177161595
"S01002491",477,521,44,0.0844529750479846,0.413815312960783
"S01002492",614,666,52,0.0780780780780781,0.44354881132444
"S01002493",871,1017,146,0.143559488692232,0.212310767770772
"S01002494",663,740,77,0.104054054054054,0.333286779432728
"S01002495",651,752,101,0.134308510638298,0.23639129497554
"S01002496",585,662,77,0.11631419939577,0.290388067412949
"S01002497",647,886,239,0.269751693002257,0.0431226645248846
"S01002498",691,758,67,0.0883905013192612,0.396358720173233
"S01002499",778,927,149,0.160733549083064,0.173379852222569
"S01002500",541,637,96,0.150706436420722,0.195244283750506
"S01002501",444,533,89,0.166979362101313,0.160900580471546
"S01002502",823,928,105,0.113146551724138,0.300966799466885
"S01002503",488,622,134,0.215434083601286,0.0883678671797246
"S01002504",801,963,162,0.168224299065421,0.158512052539413
"S01002505",709,799,90,0.112640801001252,0.302687550390577
"S01002506",821,943,122,0.129374337221633,0.250215750370317
"S01002507",544,658,114,0.173252279635258,0.149186683974854
"S01002508",781,887,106,0.119503945885006,0.280074868319525
"S01002509",930,1073,143,0.133271202236719,0.239239158348417
"S01002510",970,1074,104,0.0968342644320298,0.361139114659365
"S01002511",475,527,52,0.0986717267552182,0.353858754142546
"S01002512",492,595,103,0.173109243697479,0.149444993466861
"S01002513",705,1000,295,0.295,0.0303313101503275
"S01002514",547,626,79,0.126198083067093,0.259495559887894
"S01002515",552,653,101,0.154670750382848,0.186319780778382
"S01002516",686,817,131,0.160342717258262,0.174188946180093
"S01002517",551,658,107,0.162613981762918,0.169534095037834
"S01002518",637,753,116,0.154050464807437,0.187691481074517
"S01002519",791,966,175,0.181159420289855,0.135516935064163
"S01002520",575,708,133,0.187853107344633,0.124837732004366
"S01002521",512,643,131,0.203732503888025,0.102468382440754
"S01002522",674,756,82,0.108465608465608,0.317234937237299
"S01002523",663,748,85,0.113636363636364,0.299308675706572
"S01002524",536,645,109,0.168992248062016,0.157054632375506
"S01002525",623,778,155,0.199228791773779,0.108413782425788
"S01002526",541,612,71,0.116013071895425,0.291379121519133
"S01002527",692,880,188,0.213636363636364,0.0904136960080503
"S01002528",694,804,110,0.13681592039801,0.229632956351369
"S01002529",825,954,129,0.135220125786164,0.233913743024193
"S01002530",699,822,123,0.14963503649635,0.197721356822503
"S01002531",846,933,87,0.0932475884244373,0.375739793993755
"S01002532",728,834,106,0.127098321342926,0.256834456023496
"S01002533",813,923,110,0.119176598049837,0.281117864899722
"S01002534",914,1011,97,0.095944609297725,0.364712292604577
"S01002535",447,547,100,0.182815356489945,0.13280119040537
"S01002536",468,556,88,0.158273381294964,0.178529757436437
"S01002537",574,643,69,0.107309486780715,0.321372857790663
"S01002538",857,1004,147,0.146414342629482,0.205338833789643
"S01002539",742,852,110,0.129107981220657,0.250982305934676
"S01002540",572,711,139,0.19549929676512,0.11357017124599
"S01002541",917,1056,139,0.131628787878788,0.243811493450903
"S01002542",534,642,108,0.168224299065421,0.158512052539413
"S01002543",557,636,79,0.124213836477987,0.265448817641634
"S01002544",705,829,124,0.149577804583836,0.197854469070533
"S01002545",589,687,98,0.142649199417758,0.214578189824898
"S01002546",622,709,87,0.122708039492243,0.270048329479582
"S01002547",663,799,136,0.170212765957447,0.154763125153735
"S01002548",934,1074,140,0.130353817504655,0.24741495593644
"S01002549",532,604,72,0.119205298013245,0.281026281393337
"S01002550",502,576,74,0.128472222222222,0.252820529879194
"S01002551",557,632,75,0.118670886075949,0.282736038655867
"S01002552",552,631,79,0.125198098256735,0.262480584724227
"S01002553",746,893,147,0.16461366181411,0.16552884542941
"S01002554",619,711,92,0.129395218002813,0.25015574597684
"S01002555",630,759,129,0.1699604743083,0.155234317137232
"S01002556",730,818,88,0.107579462102689,0.320402255362757
"S01002557",836,986,150,0.152129817444219,0.191996638450231
"S01002558",497,556,59,0.106115107913669,0.325698659799504
"S01002559",647,728,81,0.111263736263736,0.307417802332212
"S01002560",528,615,87,0.141463414634146,0.2175645173376
"S01002561",643,724,81,0.111878453038674,0.305298075932293
"S01002562",605,703,98,0.139402560455192,0.222843769600295
"S01002563",1098,1264,166,0.131329113924051,0.244654192082775
"S01002564",604,649,45,0.0693374422187981,0.487441406436618
"S01002565",852,1006,154,0.153081510934394,0.189852421362462
"S01002566",738,843,105,0.124555160142349,0.264416085789662
"S01002567",282,587,305,0.519591141396934,0.000654802110795379
"S01002568",690,792,102,0.128787878787879,0.251906336219225
"S01002569",921,1044,123,0.117816091954023,0.285490272613514
"S01002570",549,668,119,0.17814371257485,0.140591420756178
"S01002571",602,687,85,0.12372634643377,0.266930095588827
"S01002572",524,639,115,0.179968701095462,0.137500503431127
"S01002573",489,564,75,0.132978723404255,0.240047701237792
"S01002574",706,865,159,0.183815028901734,0.131185530498803
"S01002575",643,1130,487,0.430973451327434,0.00355897792631911
"S01002576",669,805,136,0.168944099378882,0.157145653736656
"S01002577",859,1077,218,0.202414113277623,0.104177661700283
"S01002578",684,847,163,0.192443919716647,0.117957867861603
"S01002579",667,920,253,0.275,0.0401217683124734
"S01002580",719,914,195,0.213347921225383,0.0907458862601742
"S01002581",658,866,208,0.240184757505774,0.064132772621095
"S01002582",670,750,80,0.106666666666667,0.323694554310093
"S01002583",676,873,197,0.225658648339061,0.0775040723178636
"S01002584",692,901,209,0.23196448390677,0.0714188799224347
"S01002585",784,981,197,0.200815494393476,0.106284651545995
"S01002586",495,621,126,0.202898550724638,0.10354663442006
"S01002587",656,782,126,0.161125319693095,0.172572210931032
"S01002588",716,867,151,0.174163783160323,0.147550011714618
"S01002589",744,837,93,0.111111111111111,0.307946147657439
"S01002590",728,795,67,0.0842767295597484,0.41461261000366
"S01002591",539,613,74,0.120717781402936,0.276237672861353
"S01002592",879,983,104,0.105798575788403,0.326853825573988
"S01002593",706,826,120,0.145278450363196,0.208087761021929
"S01002594",537,765,228,0.298039215686275,0.0290488206667821
"S01002595",618,743,125,0.168236877523553,0.158488083318658
"S01002596",708,792,84,0.106060606060606,0.325897298929689
"S01002597",477,544,67,0.123161764705882,0.268654916912567
"S01002598",837,1002,165,0.164670658682635,0.165415942820714
"S01002599",518,591,73,0.123519458544839,0.267560986566651
"S01002600",762,942,180,0.191082802547771,0.119961167960737
"S01002601",615,718,103,0.143454038997214,0.212572321421632
"S01002602",494,563,69,0.122557726465364,0.270511380493022
"S01002603",675,810,135,0.166666666666667,0.161505582889846
"S01002604",930,1079,149,0.138090824837813,0.226263780242356
"S01002605",581,671,90,0.134128166915052,0.236884215078112
"S01002606",551,639,88,0.137715179968701,0.227251839295847
"S01002607",812,925,113,0.122162162162162,0.271733363831125
"S01002608",553,655,102,0.155725190839695,0.184008681369685
"S01002609",734,852,118,0.13849765258216,0.225198063416376
"S01002610",866,975,109,0.111794871794872,0.305585514089113
"S01002611",809,921,112,0.121606948968512,0.273456917612636
"S01002612",690,833,143,0.171668667466987,0.152069071170589
"S01002613",827,964,137,0.142116182572614,0.215915965443773
"S01002614",869,1040,171,0.164423076923077,0.165906870573145
"S01002615",486,607,121,0.199341021416804,0.108261934192956
"S01002616",598,693,95,0.137085137085137,0.228917763244715
"S01002617",903,1008,105,0.104166666666667,0.332868103801781
"S01002618",723,848,125,0.147405660377358,0.202966540970329
"S01002619",741,845,104,0.123076923076923,0.268914976828499
"S01002620",739,914,175,0.191466083150985,0.119393979163728
"S01002621",594,692,98,0.141618497109827,0.217171837148423
"S01002622",301,955,654,0.684816753926702,9.67456039472414e-06
"S01002623",490,720,230,0.319444444444444,0.0213125706485848
"S01002624",723,865,142,0.164161849710983,0.166426277111111
"S01002625",924,1061,137,0.129123468426013,0.250937676940627
"S01002626",688,815,127,0.155828220858896,0.183784251952797
"S01002627",1028,1138,110,0.0966608084358524,0.361833294117926
"S01002628",748,862,114,0.132250580046404,0.242071309980225
"S01002629",752,866,114,0.131639722863741,0.243780793170844
"S01002630",584,688,104,0.151162790697674,0.194197703030306
"S01002631",671,826,155,0.187651331719128,0.125148234848214
"S01002632",561,646,85,0.131578947368421,0.243951466173481
"S01002633",908,1077,169,0.156917363045497,0.181426804873315
"S01002634",732,827,95,0.114873035066505,0.295158785763896
"S01002635",553,618,65,0.105177993527508,0.329129312162157
"S01002636",512,607,95,0.156507413509061,0.182310926860354
"S01002637",730,877,147,0.167616875712657,0.159673434751493
"S01002638",656,857,201,0.234539089848308,0.0690605725431558
"S01002639",919,1111,192,0.172817281728173,0.149973499148227
"S01002640",718,824,106,0.128640776699029,0.252331997383351
"S01002641",889,1025,136,0.132682926829268,0.240867916370639
"S01002642",528,619,91,0.147011308562197,0.203907281729008
"S01002643",469,564,95,0.168439716312057,0.158102008554512
"S01002644",706,814,108,0.132678132678133,0.240881230831457
"S01002645",593,729,136,0.186556927297668,0.126844502798788
"S01002646",553,736,183,0.248641304347826,0.0573420440045329
"S01002647",894,979,85,0.0868232890704801,0.403225760728603
"S01002648",710,796,86,0.108040201005025,0.31875192028943
"S01002649",737,913,176,0.192771084337349,0.117480856267308
"S01002650",645,710,65,0.0915492957746479,0.38283678387365
"S01002651",631,720,89,0.123611111111111,0.267281332726821
"S01002652",680,800,120,0.15,0.196874404340723
"S01002653",687,884,197,0.222850678733032,0.0803608867680474
"S01002654",679,742,63,0.0849056603773585,0.411773780829319
"S01002655",727,936,209,0.223290598290598,0.0799071463174246
"S01002656",956,1288,332,0.257763975155279,0.0507481590736518
"S01002657",745,869,124,0.142692750287687,0.214469215400889
"S01002658",828,1181,353,0.298899237933954,0.0286948786003428
"S01002659",880,989,109,0.110212335692619,0.311074065785891
"S01002660",858,1019,161,0.157998037291462,0.179114620989667
"S01002661",811,947,136,0.143611404435058,0.212182104251342
"S01002662",773,859,86,0.10011641443539,0.348227689156951
"S01002663",630,778,148,0.190231362467866,0.121229837951423
"S01002664",897,1012,115,0.113636363636364,0.299308675706572
"S01002665",734,846,112,0.132387706855792,0.24168904673185
"S01002666",722,885,163,0.184180790960452,0.130598824734422
"S01002667",575,699,124,0.177396280400572,0.141875266211928
"S01002668",495,545,50,0.0917431192660551,0.382020762046467
"S01002669",847,1050,203,0.193333333333333,0.116665141629992
"S01002670",616,690,74,0.107246376811594,0.321600128993616
"S01002671",780,1080,300,0.277777777777778,0.0386107708316231
"S01002672",594,762,168,0.220472440944882,0.082854239697868
"S01002673",464,609,145,0.238095238095238,0.0659184336634629
"S01002674",701,799,98,0.122653316645807,0.270216824834613
"S01002675",874,1031,157,0.152279340446169,0.19165831846922
"S01002676",764,865,101,0.116763005780347,0.288916610452597
"S01002677",836,1124,288,0.256227758007117,0.05180833819324
"S01002678",896,1074,178,0.165735567970205,0.163319214692688
"S01002679",848,1056,208,0.196969696969697,0.111511418556929
"S01002680",861,1131,270,0.238726790450928,0.0653740612029881
"S01002681",672,840,168,0.2,0.1073741824
"S01002682",554,623,69,0.110754414125201,0.309184120473106
"S01002683",797,881,84,0.0953461975028377,0.367133597435278
"S01002684",658,777,119,0.153153153153153,0.189691883217562
"S01002685",810,1043,233,0.223394055608821,0.0798007741581979
"S01002686",791,959,168,0.175182481751825,0.145739999356144
"S01002687",747,880,133,0.151136363636364,0.194258171558424
"S01002688",666,796,130,0.163316582914573,0.16811699333607
"S01002689",650,738,88,0.119241192411924,0.280911777755825
"S01002690",535,583,48,0.0823327615780446,0.423498886342644
"S01002691",853,1244,391,0.314308681672026,0.0229766393859863
"S01002692",856,974,118,0.121149897330595,0.274883124077969
"S01002693",431,561,130,0.231729055258467,0.0716381049751382
"S01002694",713,844,131,0.15521327014218,0.185127455621207
"S01002695",582,654,72,0.110091743119266,0.311495920466036
"S01002696",713,829,116,0.139927623642943,0.221487893647417
"S01002697",853,956,103,0.107740585774059,0.319824249109931
"S01002698",628,769,141,0.183355006501951,0.131926803336832
"S01002699",494,564,70,0.124113475177305,0.265753167402429
"S01002700",825,978,153,0.156441717791411,0.182452970145664
"S01002701",867,986,119,0.120689655172414,0.276326047705959
"S01002702",578,652,74,0.113496932515337,0.299779842356811
"S01002703",837,1019,182,0.178606476938175,0.139801792506112
"S01002704",652,717,65,0.0906555090655509,0.38662007491108
"S01002705",633,717,84,0.117154811715481,0.287637525211717
"S01002706",715,888,173,0.19481981981982,0.114533032633164
"S01002707",829,1003,174,0.173479561316052,0.148777061021847
"S01002708",658,787,129,0.163913595933926,0.166921243948882
"S01002709",539,697,158,0.226685796269727,0.0764821117737851
"S01002710",488,617,129,0.209076175040519,0.0957958245026616
"S01002711",854,941,87,0.0924548352816153,0.379037756318616
"S01002712",754,840,86,0.102380952380952,0.339563184686489
"S01002713",712,855,143,0.167251461988304,0.160375782759968
"S01002714",831,993,162,0.163141993957704,0.16846812909827
"S01002715",858,975,117,0.12,0.278500976009402
"S01002716",505,643,138,0.214618973561431,0.0892902526759154
"S01002717",710,824,114,0.138349514563107,0.225585598294927
"S01002718",798,992,194,0.195564516129032,0.113478135617313
"S01002719",742,836,94,0.11244019138756,0.303372547454259
"S01002720",749,805,56,0.0695652173913043,0.48624973014885
"S01002721",724,850,126,0.148235294117647,0.201000160787322
"S01002722",597,770,173,0.224675324675325,0.0784939274468267
"S01002723",596,656,60,0.0914634146341463,0.383198855804077
"S01002724",726,894,168,0.187919463087248,0.124735771934136
"S01002725",870,971,101,0.104016477857878,0.333426587122356
"S01002726",662,852,190,0.223004694835681,0.0802017688454708
"S01002727",883,1061,178,0.167766258246937,0.159387110245799
"S01002728",783,944,161,0.170550847457627,0.154133726180412
"S01002729",863,1019,156,0.153091265947007,0.189830554833414
"S01002730",678,861,183,0.212543554006969,0.0916780620100146
"S01002731",712,864,152,0.175925925925926,0.144431696188408
"S01002732",558,750,192,0.256,0.0519672045294423
"S01002733",555,675,120,0.177777777777778,0.141218665425476
"S01002734",868,1010,142,0.140594059405941,0.219777644237796
"S01002735",788,1017,229,0.225172074729597,0.0779924648140791
"S01002736",675,753,78,0.103585657370518,0.335033293245229
"S01002737",644,825,181,0.219393939393939,0.0840077180927416
"S01002738",681,765,84,0.109803921568627,0.312504854111276
"S01002739",776,839,63,0.0750893921334922,0.458139359466591
"S01002740",551,613,62,0.101141924959217,0.344279563235616
"S01002741",795,951,156,0.16403785488959,0.166673331852849
"S01002742",774,877,103,0.117445838084379,0.286690744976893
"S01002743",486,651,165,0.253456221198157,0.0537715811343872
"S01002744",537,605,68,0.112396694214876,0.303521255839564
"S01002745",568,654,86,0.131498470948012,0.244177629849264
"S01002746",752,934,182,0.194860813704497,0.114474734149172
"S01002747",535,651,116,0.178187403993856,0.140516697602248
"S01002748",516,648,132,0.203703703703704,0.102505450243795
"S01002749",693,861,168,0.195121951219512,0.114103990116625
"S01002750",860,970,110,0.11340206185567,0.30010081148262
"S01002751",896,1047,151,0.14422158548233,0.210675134488149
"S01002752",528,588,60,0.102040816326531,0.34085209256968
"S01002753",698,759,61,0.080368906455863,0.432649760137528
"S01002754",551,639,88,0.137715179968701,0.227251839295847
"S01002755",720,875,155,0.177142857142857,0.142312954217118
"S01002756",732,911,179,0.19648737650933,0.11218299770453
"S01002757",540,610,70,0.114754098360656,0.295555637853674
"S01002758",666,797,131,0.164366373902133,0.16601949089331
"S01002759",666,866,200,0.23094688221709,0.0723707996844973
"S01002760",492,552,60,0.108695652173913,0.316417321868319
"S01002761",679,866,187,0.215935334872979,0.0878049141545799
"S01002762",622,801,179,0.223470661672909,0.0797220919078089
"S01002763",839,1004,165,0.164342629482072,0.166066671146728
"S01002764",618,692,74,0.106936416184971,0.322718458427185
"S01002765",651,844,193,0.228672985781991,0.0745393187863125
"S01002766",808,973,165,0.169578622816033,0.155949937507608
"S01002767",868,1014,146,0.143984220907298,0.211260207389679
"S01002768",812,899,87,0.0967741935483871,0.361379385509619
"S01002769",722,853,131,0.153575615474795,0.188747698182205
"S01002770",498,585,87,0.148717948717949,0.199864088273339
"S01002771",732,861,129,0.149825783972125,0.197278290556855
"S01002772",982,1148,166,0.144599303135889,0.209747115618453
"S01002773",914,1047,133,0.127029608404967,0.257036702200697
"S01002774",714,863,149,0.172653534183082,0.150270648492496
"S01002775",732,909,177,0.194719471947195,0.114675852765142
"S01002776",573,727,154,0.211829436038514,0.0925128608245018
"S01002777",933,1081,148,0.13691026827012,0.229382086020363
"S01002778",762,948,186,0.19620253164557,0.112581320938442
"S01002779",560,717,157,0.218967921896792,0.0844673196859706
"S01002780",840,1023,183,0.178885630498534,0.139327397021401
"S01002781",897,1000,103,0.103,0.337228623971846
"S01002782",806,907,101,0.11135611907387,0.307098395544971
"S01002783",749,869,120,0.138089758342923,0.226266579963208
"S01002784",526,603,77,0.127694859038143,0.255084646998019
"S01002785",686,839,153,0.182359952324195,0.133543129298074
"S01002786",648,764,116,0.151832460732984,0.192671053897573
"S01002787",724,824,100,0.121359223300971,0.274229104204692
"S01002788",742,886,144,0.162528216704289,0.16970781187213
"S01002789",727,819,92,0.112332112332112,0.303742169769736
"S01002790",717,901,184,0.204217536071032,0.101845922641342
"S01002791",637,769,132,0.171651495448635,0.152100599333296
"S01002792",839,986,147,0.149087221095335,0.198998800611382
"S01002793",728,882,154,0.174603174603175,0.146766839379945
"S01002794",839,924,85,0.091991341991342,0.380977998689431
"S01002795",629,733,104,0.141882673942701,0.216504390594695
"S01002796",515,633,118,0.186413902053712,0.12706770621168
"S01002797",790,903,113,0.125138427464009,0.262659679362188
"S01002798",519,626,107,0.170926517571885,0.153437052216509
"S01002799",573,658,85,0.129179331306991,0.250776757965697
"S01002800",774,860,86,0.1,0.3486784401
"S01002801",932,1059,127,0.119924457034939,0.278740145539285
"S01002802",626,679,53,0.0780559646539028,0.443655213412719
"S01002803",794,888,94,0.105855855855856,0.326644512406136
"S01002804",555,667,112,0.16791604197901,0.159100480792415
"S01002805",787,895,108,0.120670391061453,0.276386591750527
"S01002806",559,650,91,0.14,0.221301578888031
"S01002807",666,771,105,0.136186770428016,0.231312185092848
"S01002808",789,920,131,0.142391304347826,0.215224525314468
"S01002809",686,792,106,0.133838383838384,0.237678195288916
"S01002810",882,1043,161,0.154362416107383,0.187000499699775
"S01002811",903,1016,113,0.111220472440945,0.307567486594764
"S01002812",602,655,53,0.0809160305343511,0.430082639763059
"S01002813",710,885,175,0.19774011299435,0.110446200518014
"S01002814",683,791,108,0.13653603034134,0.230378635581978
"S01002815",698,837,139,0.166069295101553,0.162667070816743
"S01002816",502,620,118,0.190322580645161,0.121093345126186
"S01002817",541,610,69,0.113114754098361,0.301074726812749
"S01002818",511,646,135,0.208978328173375,0.0959144015502823
"S01002819",776,934,158,0.169164882226981,0.156728670756552
"S01002820",854,997,143,0.143430290872618,0.212631265413979
"S01002821",881,1050,169,0.160952380952381,0.17292830849182
"S01002822",838,987,149,0.15096251266464,0.194656387624691
"S01002823",728,897,169,0.188405797101449,0.123990771613161
"S01002824",727,820,93,0.113414634146341,0.300058258779519
"S01002825",894,1081,187,0.172987974098057,0.149664310221125
"S01002826",511,583,72,0.123499142367067,0.267623011715391
"S01002827",630,735,105,0.142857142857143,0.214058315601308
"S01002828",476,686,210,0.306122448979592,0.0258719027525799
"S01002829",760,880,120,0.136363636363636,0.230839009056934
"S01002830",588,684,96,0.140350877192982,0.220400331584146
"S01002831",741,856,115,0.134345794392523,0.236289505283478
"S01002832",740,892,152,0.170403587443946,0.154407593204058
"S01002833",1055,1207,152,0.125932062966031,0.260286650884912
"S01002834",863,990,127,0.128282828282828,0.253370478248755
"S01002835",685,821,136,0.165651644336175,0.163483581621855
"S01002836",546,624,78,0.125,0.263075576163828
"S01002837",542,688,146,0.212209302325581,0.092067952086326
"S01002838",530,605,75,0.12396694214876,0.26619809885281
"S01002839",498,581,83,0.142857142857143,0.214058315601308
"S01002840",623,742,119,0.160377358490566,0.174117095441232
"S01002841",579,681,102,0.149779735682819,0.197385169148507
"S01002842",556,689,133,0.193033381712627,0.117099676892002
"S01002843",806,984,178,0.180894308943089,0.135956330312101
"S01002844",566,639,73,0.114241001564945,0.297273180954565
"S01002845",679,888,209,0.23536036036036,0.0683231820895178
"S01002846",861,970,109,0.112371134020619,0.303608671778899
"S01002847",859,1012,153,0.151185770750988,0.194145135472112
"S01002848",794,947,153,0.16156282998944,0.171674279839645
"S01002849",969,1128,159,0.140957446808511,0.218850112417333
"S01002850",815,1019,204,0.200196270853778,0.107111042762375
"S01002851",574,704,130,0.184659090909091,0.129835164509696
"S01002852",922,1074,152,0.141527001862197,0.21740343259328
"S01002853",456,599,143,0.23873121869783,0.0653702585615361
"S01002854",776,902,126,0.139689578713969,0.222101676703129
"S01002855",639,757,118,0.155878467635403,0.183674889221353
"S01002856",687,872,185,0.212155963302752,0.0921303076221223
"S01002857",490,523,33,0.0630975143403442,0.52112740404828
"S01002858",453,518,65,0.125482625482625,0.261628121322989
"S01002859",795,947,152,0.160506863780359,0.173848719636113
"S01002860",940,1170,230,0.196581196581197,0.112052078934219
"S01002861",882,1065,183,0.171830985915493,0.151771341750295
"S01002862",585,702,117,0.166666666666667,0.161505582889846
"S01002863",708,830,122,0.146987951807229,0.203963123023929
"S01002864",555,682,127,0.186217008797654,0.127375553632688
"S01002865",875,960,85,0.0885416666666667,0.395701958541024
"S01002866",997,1181,184,0.15580016934801,0.183845331901782
"S01002867",546,608,62,0.101973684210526,0.341107001949217
"S01002868",698,828,130,0.157004830917874,0.181238666613947
"S01002869",524,587,63,0.10732538330494,0.321315634128215
"S01002870",863,959,96,0.100104275286757,0.348274666836723
"S01002871",560,631,71,0.112519809825674,0.303100517330975
"S01002872",565,657,92,0.140030441400304,0.221223257295208
"S01002873",736,854,118,0.138173302107728,0.226047358540842
"S01002874",824,1013,189,0.186574531095755,0.126817054933682
"S01002875",673,868,195,0.224654377880184,0.0785151365760973
"S01002876",616,762,146,0.191601049868766,0.119194827168343
"S01002877",769,977,208,0.212896622313204,0.091267837572988
"S01002878",518,599,81,0.135225375626043,0.233899543154531
"S01002879",796,971,175,0.180226570545829,0.137068726662545
"S01002880",492,554,62,0.111913357400722,0.305178110932122
"S01002881",784,1000,216,0.216,0.0877325246008235
"S01002882",626,865,239,0.276300578034682,0.0394078060849855
"S01002883",1052,1190,138,0.115966386554622,0.2915330419728
"S01002884",735,850,115,0.135294117647059,0.23371367996492
"S01002885",635,859,224,0.260768335273574,0.0487310326586578
"S01002886",587,704,117,0.166193181818182,0.162425578057973
"S01002887",585,669,84,0.125560538116592,0.261395124629182
"S01002888",549,634,85,0.134069400630915,0.237045036309609
"S01002889",796,899,103,0.114571746384872,0.296165018143369
"S01002890",676,817,141,0.172582619339045,0.150399500566949
"S01002891",737,855,118,0.138011695906433,0.226471591113209
"S01002892",627,692,65,0.0939306358381503,0.372918959445071
"S01002893",672,793,121,0.152585119798235,0.190968113267319
"S01002894",700,840,140,0.166666666666667,0.161505582889846
"S01002895",594,700,106,0.151428571428571,0.1935905036364
"S01002896",684,750,66,0.088,0.398059857579335
"S01002897",539,655,116,0.177099236641221,0.142388413773796
"S01002898",944,1044,100,0.0957854406130268,0.365354916830844
"S01002899",468,534,66,0.123595505617978,0.267328930218034
"S01002900",704,796,92,0.115577889447236,0.292816748648252
"S01002901",801,882,81,0.0918367346938776,0.38162718997767
"S01002902",783,893,110,0.123180291153415,0.26859815903159
"S01002903",801,939,138,0.146964856230032,0.204018353428291
"S01002904",571,695,124,0.17841726618705,0.140124164647582
"S01002905",668,817,149,0.182374541003672,0.133519303881273
"S01002906",755,927,172,0.18554476806904,0.128431683341612
"S01002907",575,645,70,0.108527131782946,0.317016086611397
"S01002908",699,818,119,0.145476772616137,0.207605435869781
"S01002909",669,797,128,0.16060225846926,0.173651269936994
"S01002910",724,855,131,0.153216374269006,0.189550316834863
"S01002911",886,951,65,0.0683491062039958,0.492642697409846
"S01002912",888,1028,140,0.136186770428016,0.231312185092848
"S01002913",716,870,154,0.177011494252874,0.142540309316209
"S01002914",620,787,167,0.212198221092757,0.0920809033815925
"S01002915",925,1101,176,0.159854677565849,0.175204048634481
"S01002916",797,876,79,0.0901826484018265,0.388635216751892
"S01002917",600,741,141,0.190283400809717,0.121151954276744
"S01002918",743,850,107,0.125882352941176,0.260434719097974
"S01002919",849,1084,235,0.216789667896679,0.0868528512812854
"S01002920",588,699,111,0.158798283261803,0.177419562223408
"S01002921",684,766,82,0.107049608355091,0.322309659147099
"S01002922",512,615,103,0.167479674796748,0.159936818250591
"S01002923",635,777,142,0.182754182754183,0.132900637723958
"S01002924",663,740,77,0.104054054054054,0.333286779432728
"S01002925",925,1095,170,0.155251141552511,0.185044480553073
"S01002926",753,929,176,0.189451022604952,0.122403157809504
"S01002927",722,845,123,0.145562130177515,0.207398153846084
"S01002928",527,595,68,0.114285714285714,0.297123152856603
"S01002929",741,892,151,0.169282511210762,0.156506916852311
"S01002930",590,723,133,0.183955739972337,0.130959540767205
"S01002931",731,850,119,0.14,0.221301578888031
"S01002932",709,838,129,0.153937947494033,0.187941273584924
"S01002933",786,917,131,0.142857142857143,0.214058315601308
"S01002934",815,1046,231,0.220841300191205,0.082463021213555
"S01002935",762,894,132,0.147651006711409,0.202383231186795
"S01002936",600,804,204,0.253731343283582,0.0535737462522145
"S01002937",548,696,148,0.21264367816092,0.0915615611143968
"S01002938",731,895,164,0.183240223463687,0.132112349576252
"S01002939",504,578,74,0.1280276816609,0.254113056665771
"S01002940",456,598,142,0.237458193979933,0.0664716695191208
"S01002941",873,1051,178,0.169362511893435,0.156356261114957
"S01002942",504,633,129,0.203791469194313,0.102392527699069
"S01002943",504,569,65,0.114235500878735,0.297291642547253
"S01002944",823,1046,223,0.213193116634799,0.0909246225375663
"S01002945",654,736,82,0.111413043478261,0.306901732344804
"S01002946",559,687,128,0.186317321688501,0.127218628201639
"S01002947",569,675,106,0.157037037037037,0.181169437383277
"S01002948",804,945,141,0.149206349206349,0.198720376989935
"S01002949",479,541,62,0.11460258780037,0.29606187351539
"S01002950",690,796,106,0.133165829145729,0.239530174014908
"S01002951",837,950,113,0.118947368421053,0.281850316631438
"S01002952",571,660,89,0.134848484848485,0.234920938432854
"S01002953",889,1044,155,0.148467432950192,0.200453028944023
"S01002954",783,913,130,0.142387732749179,0.215233488726728
"S01002955",924,1078,154,0.142857142857143,0.214058315601308
"S01002956",703,812,109,0.13423645320197,0.236588133370893
"S01002957",915,1005,90,0.0895522388059701,0.39133646991609
"S01002958",501,635,134,0.211023622047244,0.0934630621391713
"S01002959",908,1048,140,0.133587786259542,0.238366740989156
"S01002960",635,740,105,0.141891891891892,0.216481134683851
"S01002961",675,816,141,0.172794117647059,0.150015502396542
"S01002962",571,691,120,0.173661360347323,0.148450139046614
"S01002963",730,850,120,0.141176470588235,0.218292766095984
"S01002964",736,886,150,0.169300225733634,0.15647354594863
"S01002965",740,903,163,0.180509413067553,0.136596538553106
"S01002966",739,912,173,0.18969298245614,0.122038258241973
"S01002967",768,900,132,0.146666666666667,0.204732649090523
"S01002968",596,786,190,0.241730279898219,0.0628401389994781
"S01002969",914,1071,157,0.146591970121382,0.204911932453318
"S01002970",473,608,135,0.222039473684211,0.0812036619648311
"S01002971",975,1165,190,0.163090128755365,0.168572568212235
"S01002972",797,1042,245,0.235124760076775,0.068533991176873
"S01002973",812,937,125,0.133404482390608,0.238871525744676
"S01002974",552,698,146,0.209169054441261,0.0956833894213725
"S01002975",561,738,177,0.239837398373984,0.0644265675866495
"S01002976",853,1064,211,0.198308270676692,0.109666512342281
"S01002977",623,785,162,0.206369426751592,0.0991251594999427
"S01002978",949,1161,212,0.18260120585702,0.133149618637983
"S01002979",646,764,118,0.154450261780105,0.186806332505579
"S01002980",719,863,144,0.166859791425261,0.161131684264091
"S01002981",723,884,161,0.182126696832579,0.133924589175826
"S01002982",645,737,92,0.12483039348711,0.263585956403531
"S01002983",715,834,119,0.142685851318945,0.214486474907275
"S01002984",650,812,162,0.199507389162562,0.108037188548154
"S01002985",511,601,90,0.149750415973378,0.197453247671365
"S01002986",653,869,216,0.248561565017261,0.0574029283797223
"S01002987",576,880,304,0.345454545454545,0.014434379280972
"S01002988",646,741,95,0.128205128205128,0.253596409375097
"S01002989",808,1103,295,0.267452402538531,0.0444998434708966
"S01002990",379,744,365,0.490591397849462,0.00117669184665952
"S01002991",734,1012,278,0.274703557312253,0.0402861229771085
"S01002992",484,806,322,0.399503722084367,0.00609681754486221
"S01002993",715,1318,603,0.457511380880121,0.002207528480911
"S01002994",659,1401,742,0.529621698786581,0.000530240374021395
"S01002995",262,853,591,0.69284876905041,7.47347526585535e-06
"S01002996",821,2379,1558,0.654897015552753,2.39600185980403e-05
"S01002997",388,857,469,0.547257876312719,0.000361833719615579
"S01002998",736,864,128,0.148148148148148,0.201205903295558
"S01002999",462,1349,887,0.657524091919941,2.2197305479271e-05
"S01003000",672,941,269,0.28586609989373,0.0344982048158342
"S01003001",575,636,61,0.0959119496855346,0.364844068806828
"S01003002",688,823,135,0.164034021871203,0.166680974245884
"S01003003",504,630,126,0.2,0.1073741824
"S01003004",488,570,82,0.143859649122807,0.211567845431265
"S01003005",468,620,152,0.245161290322581,0.0600539579803688
"S01003006",659,784,125,0.159438775510204,0.17607330614405
"S01003007",648,927,279,0.300970873786408,0.0278581785308074
"S01003008",656,1342,686,0.511177347242921,0.000778956553435537
"S01003009",455,608,153,0.251644736842105,0.055090685177616
"S01003010",538,646,108,0.1671826625387,0.160508330198892
"S01003011",430,841,411,0.488703923900119,0.00122102511744955
"S01003012",927,1048,121,0.115458015267176,0.293213873326142
"S01003013",506,613,107,0.174551386623165,0.146858951492546
"S01003014",640,717,77,0.107391910739191,0.321076250854124
"S01003015",715,825,110,0.133333333333333,0.2390677160551
"S01003016",524,631,107,0.169572107765452,0.155962172953731
"S01003017",649,771,122,0.158236057068742,0.178608937715424
"S01003018",672,872,200,0.229357798165138,0.0738801691700856
"S01003019",753,867,114,0.131487889273356,0.244207381666832
"S01003020",551,699,148,0.21173104434907,0.0926284146425248
"S01003021",615,754,139,0.184350132625995,0.130327990512629
"S01003022",902,1044,142,0.136015325670498,0.231771690668207
"S01003023",732,859,127,0.147846332945285,0.201919923149232
"S01003024",603,764,161,0.210732984293194,0.0938079263013616
"S01003025",695,792,97,0.122474747474747,0.270767309764528
"S01003026",564,690,126,0.182608695652174,0.133137418690343
"S01003027",1053,1236,183,0.148058252427184,0.201418336262672
"S01003028",664,819,155,0.189255189255189,0.122699212697843
"S01003029",716,850,134,0.157647058823529,0.179862640950281
"S01003030",731,913,182,0.19934282584885,0.108259494336195
"S01003031",435,549,114,0.207650273224044,0.0975369396809365
"S01003032",684,803,119,0.148194271481943,0.201096987335708
"S01003033",519,629,110,0.174880763116057,0.146273995381238
"S01003034",857,937,80,0.0853788687299893,0.409649387978396
"S01003035",696,815,119,0.14601226993865,0.206308113905653
"S01003036",879,1011,132,0.130563798219585,0.246818207995603
"S01003037",712,836,124,0.148325358851675,0.200787726362131
"S01003038",822,973,151,0.1551901336074,0.185178163516823
"S01003039",932,1087,155,0.142594296228151,0.214715641409169
"S01003040",946,1055,109,0.103317535545024,0.336036743755448
"S01003041",669,804,135,0.167910447761194,0.159111177665773
"S01003042",601,704,103,0.146306818181818,0.20559764161145
"S01003043",488,631,143,0.22662440570523,0.0765428497982858
"S01003044",990,1174,184,0.156729131175468,0.181832276845289
"S01003045",766,921,155,0.168295331161781,0.158376738205838
"S01003046",704,835,131,0.15688622754491,0.181493817915648
"S01003047",999,1125,126,0.112,0.304880506868562
"S01003048",759,917,158,0.172300981461287,0.150912218052746
"S01003049",536,622,86,0.138263665594855,0.225810457171734
"S01003050",753,853,100,0.117233294255569,0.287381925528095
"S01003051",660,967,307,0.317476732161324,0.0219368676261875
"S01003052",720,811,91,0.112207151664612,0.304170031115504
"S01003053",761,974,213,0.218685831622177,0.0847728919400142
"S01003054",837,983,146,0.14852492370295,0.200317735293738
"S01003055",796,913,117,0.128148959474261,0.253759845975289
"S01003056",886,1121,235,0.209634255129349,0.0951220262610509
"S01003057",641,766,125,0.163185378590078,0.168380811740621
"S01003058",739,880,141,0.160227272727273,0.174428586897987
"S01003059",835,954,119,0.124737945492662,0.263864526175102
"S01003060",664,773,109,0.141009055627426,0.218718669070237
"S01003061",824,917,93,0.101417666303162,0.343224878748423
"S01003062",939,1096,157,0.143248175182482,0.21308377451899
"S01003063",725,922,197,0.213665943600868,0.0903796916221416
"S01003064",866,990,124,0.125252525252525,0.262317324555234
"S01003065",748,1052,304,0.288973384030418,0.0330261980148976
"S01003066",889,985,96,0.0974619289340102,0.358637174843575
"S01003067",630,693,63,0.0909090909090909,0.385543289429532
"S01003068",769,924,155,0.167748917748918,0.159420323403241
"S01003069",550,645,95,0.147286821705426,0.203249622943482
"S01003070",736,850,114,0.134117647058824,0.236912996752695
"S01003071",608,704,96,0.136363636363636,0.230839009056934
"S01003072",988,1104,116,0.105072463768116,0.329517672925647
"S01003073",722,839,117,0.139451728247914,0.222716486862981
"S01003074",735,841,106,0.126040428061831,0.259964132969187
"S01003075",670,834,164,0.196642685851319,0.111966349946406
"S01003076",891,1045,154,0.147368421052632,0.203055209430072
"S01003077",929,1098,169,0.15391621129326,0.187989563205722
"S01003078",688,747,59,0.0789825970548862,0.439216214154367
"S01003079",850,995,145,0.14572864321608,0.206994330135366
"S01003080",779,942,163,0.173036093418259,0.149577251517053
"S01003081",743,964,221,0.229253112033195,0.073980591372588
"S01003082",723,808,85,0.10519801980198,0.329055659858954
"S01003083",977,1147,170,0.14821272885789,0.201053416828141
"S01003084",830,950,120,0.126315789473684,0.259146215480591
"S01003085",924,1084,160,0.14760147601476,0.202500868495297
"S01003086",683,771,88,0.114137483787289,0.297620783948433
"S01003087",614,748,134,0.179144385026738,0.138888962187333
"S01003088",905,1088,183,0.168198529411765,0.158561168788255
"S01003089",588,650,62,0.0953846153846154,0.366977716809755
"S01003090",716,818,102,0.124694376528117,0.263995902597306
"S01003091",579,702,123,0.175213675213675,0.145684891875896
"S01003092",743,863,120,0.139049826187717,0.223758828939832
"S01003093",944,1094,150,0.137111517367459,0.228847790124816
"S01003094",946,1098,152,0.138433515482696,0.225365774977638
"S01003095",783,912,129,0.141447368421053,0.217605183982468
"S01003096",674,761,87,0.114323258869908,0.296997229206563
"S01003097",757,853,96,0.112543962485346,0.303018039014883
"S01003098",863,1171,308,0.263023057216055,0.0472649286281029
"S01003099",563,624,61,0.0977564102564103,0.357468725319936
"S01003100",787,918,131,0.142701525054466,0.214447264919649
"S01003101",574,644,70,0.108695652173913,0.316417321868319
"S01003102",763,853,90,0.105509964830012,0.327910307062139
"S01003103",752,806,54,0.0669975186104218,0.499836524226185
"S01003104",890,1051,161,0.153187440532826,0.189615094211914
"S01003105",739,854,115,0.134660421545667,0.235432100332569
"S01003106",692,805,113,0.140372670807453,0.220344462604713
"S01003107",1016,1154,138,0.119584055459272,0.279820154007604
"S01003108",645,846,201,0.23758865248227,0.0663580348145545
"S01003109",915,1037,122,0.117647058823529,0.286037765539156
"S01003110",763,881,118,0.133938706015891,0.237403050678291
"S01003111",854,1044,190,0.181992337164751,0.134144762292016
"S01003112",869,1039,170,0.163618864292589,0.167510597956185
"S01003113",712,809,97,0.119901112484549,0.278814091920339
"S01003114",902,1008,106,0.10515873015873,0.329200172662917
"S01003115",499,597,98,0.164154103852596,0.1664417007686
"S01003116",754,980,226,0.230612244897959,0.0726863233542056
"S01003117",662,876,214,0.244292237442922,0.0607489579500718
"S01003118",804,996,192,0.192771084337349,0.117480856267308
"S01003119",638,793,155,0.195460277427491,0.113625266290034
"S01003120",960,1118,158,0.141323792486583,0.217918597360116
"S01003121",864,1012,148,0.146245059288538,0.205746425946024
"S01003122",726,814,88,0.108108108108108,0.318509329699947
"S01003123",809,884,75,0.084841628959276,0.412061999887094
"S01003124",679,931,252,0.270676691729323,0.0425795368314623
"S01003125",648,917,269,0.293347873500545,0.0310496494959395
"S01003126",771,1023,252,0.24633431085044,0.0591272177190642
"S01003127",793,906,113,0.124724061810155,0.26390638418545
"S01003128",623,805,182,0.226086956521739,0.0770764427726301
"S01003129",924,1206,282,0.233830845771144,0.0697022237973299
"S01003130",664,906,242,0.267108167770419,0.0447093974505554
"S01003131",734,1000,266,0.266,0.0453900435216572
"S01003132",522,681,159,0.233480176211454,0.0700219032245629
"S01003133",1025,1346,321,0.238484398216939,0.0655825131553341
"S01003134",699,799,100,0.125156445556946,0.262605588657206
"S01003135",715,797,82,0.10288582183187,0.337658124631781
"S01003136",670,934,264,0.282655246252677,0.0360810580741206
"S01003137",571,778,207,0.266066838046273,0.0453487282767234
"S01003138",891,1094,203,0.185557586837294,0.128411470820131
"S01003139",797,1191,394,0.330814441645676,0.0180080048572419
"S01003140",926,1074,148,0.13780260707635,0.227021533622589
"S01003141",605,846,241,0.284869976359338,0.0349824414666509
"S01003142",682,756,74,0.0978835978835979,0.356965127744815
"S01003143",751,978,227,0.232106339468303,0.0712870793902096
"S01003144",842,960,118,0.122916666666667,0.269406819357409
"S01003145",716,778,62,0.0796915167095116,0.43584719285047
"S01003146",517,786,269,0.342239185750636,0.015159328723394
"S01003147",872,949,77,0.0811380400421496,0.429044881343695
"S01003148",726,809,83,0.102595797280593,0.338751315860424
"S01003149",761,1035,274,0.264734299516908,0.0461788453610228
"S01003150",723,836,113,0.135167464114833,0.234056226275459
"S01003151",756,822,66,0.0802919708029197,0.433011848000399
"S01003152",887,1052,165,0.156844106463878,0.181584510713453
"S01003153",722,877,155,0.176738882554162,0.143013172898493
"S01003154",732,1003,271,0.270189431704885,0.0428648669834749
"S01003155",816,1162,346,0.29776247848537,0.0291635445365498
"S01003156",702,995,293,0.294472361809045,0.0305590827051265
"S01003157",842,1098,256,0.233151183970856,0.07032302012136
"S01003158",679,870,191,0.219540229885057,0.0838504150428964
"S01003159",584,790,206,0.260759493670886,0.0487368614622734
"S01003160",679,868,189,0.217741935483871,0.0858026084859208
"S01003161",587,661,74,0.111951588502269,0.305046760736511
"S01003162",671,741,70,0.0944669365721997,0.37071752917946
"S01003163",605,691,86,0.124457308248915,0.264711782689433
"S01003164",817,1075,258,0.24,0.0642888893233994
"S01003165",883,1087,204,0.187672493100276,0.125115638019058
"S01003166",521,765,244,0.318954248366013,0.0214665810965876
"S01003167",746,880,134,0.152272727272727,0.191673270495961
"S01003168",693,986,293,0.297160243407708,0.0294146169173715
"S01003169",840,1116,276,0.247311827956989,0.0583647883011054
"S01003170",868,1018,150,0.147347740667976,0.203104465384285
"S01003171",595,663,68,0.102564102564103,0.338870975802271
"S01003172",568,817,249,0.304773561811506,0.0263792711387006
"S01003173",454,632,178,0.281645569620253,0.0365921346824689
"S01003174",701,881,180,0.204313280363224,0.101723453392842
"S01003175",705,883,178,0.20158550396376,0.105265033773513
"S01003176",628,927,299,0.322545846817691,0.0203609996256801
"S01003177",936,1172,236,0.201365187713311,0.1055558653753
"S01003178",798,940,142,0.151063829787234,0.194424225462645
"S01003179",607,777,170,0.218790218790219,0.0846596995259273
"S01003180",724,782,58,0.0741687979539642,0.46271985093748
"S01003181",881,1013,132,0.13030602171767,0.247550968924891
"S01003182",740,875,135,0.154285714285714,0.187170183912835
"S01003183",642,846,204,0.24113475177305,0.0633354193350713
"S01003184",817,958,141,0.147181628392484,0.203500497149258
"S01003185",493,561,68,0.121212121212121,0.274688564773928
"S01003186",776,1006,230,0.228628230616302,0.0745825804728755
"S01003187",826,1127,301,0.267080745341615,0.0447261290700132
"S01003188",694,909,215,0.236523652365237,0.0672908280136024
"S01003189",693,980,287,0.292857142857143,0.0312659471317356
"S01003190",678,805,127,0.15776397515528,0.179613152290046
"S01003191",434,604,170,0.281456953642384,0.0366883270574588
"S01003192",625,925,300,0.324324324324324,0.0198327458259139
"S01003193",621,723,102,0.141078838174274,0.218541051745224
"S01003194",736,841,105,0.124851367419738,0.263522793356342
"S01003195",770,863,93,0.107763615295481,0.319741710961585
"S01003196",872,1054,182,0.172675521821632,0.150230717197407
"S01003197",642,711,69,0.0970464135021097,0.360291713229631
"S01003198",819,1039,220,0.211742059672762,0.092615471499152
"S01003199",881,977,96,0.0982599795291709,0.355478588408014
"S01003200",595,779,184,0.23620025673941,0.0675764044642322
"S01003201",715,958,243,0.253653444676409,0.0536296950187901
"S01003202",877,968,91,0.0940082644628099,0.372599579622003
"S01003203",787,908,121,0.133259911894273,0.239270324387568
"S01003204",951,1125,174,0.154666666666667,0.186328781929651
"S01003205",734,905,171,0.188950276243094,0.123161453921216
"S01003206",638,838,200,0.238663484486873,0.0654284453184148
"S01003207",690,935,245,0.262032085561497,0.047904333114609
"S01003208",825,1004,179,0.178286852589641,0.140346749111205
"S01003209",547,626,79,0.126198083067093,0.259495559887894
"S01003210",805,994,189,0.190140845070423,0.121365419034518
"S01003211",803,1030,227,0.220388349514563,0.0829436619975173
"S01003212",720,840,120,0.142857142857143,0.214058315601308
"S01003213",558,646,88,0.136222910216718,0.231215428067874
"S01003214",773,832,59,0.0709134615384615,0.479249508634101
"S01003215",903,1071,168,0.156862745098039,0.181544374000484
"S01003216",707,765,58,0.0758169934640523,0.454548036854899
"S01003217",729,976,247,0.253073770491803,0.0540476862151077
"S01003218",700,790,90,0.113924050632911,0.298338627364604
"S01003219",719,802,83,0.103491271820449,0.335386224780492
"S01003220",733,843,110,0.130486358244365,0.247038135100519
"S01003221",761,973,212,0.217882836587873,0.0856481851787063
"S01003222",690,866,176,0.203233256351039,0.103112659214483
"S01003223",875,1077,202,0.187558031569174,0.125292044841817
"S01003224",708,792,84,0.106060606060606,0.325897298929689
"S01003225",768,847,79,0.0932703659976387,0.375645419022442
"S01003226",735,854,119,0.139344262295082,0.222994773334777
"S01003227",830,1009,179,0.177403369672944,0.141863039748859
"S01003228",847,967,120,0.124095139607032,0.265808804688585
"S01003229",970,1123,153,0.136242208370436,0.231163776057738
"S01003230",770,887,117,0.131905298759865,0.243036248832
"S01003231",938,1033,95,0.0919651500484027,0.381087907876718
"S01003232",697,876,179,0.204337899543379,0.101691983728931
"S01003233",975,1059,84,0.0793201133144476,0.437609313031746
"S01003234",767,909,142,0.156215621562156,0.182942583250259
"S01003235",721,854,133,0.155737704918033,0.183981408905269
"S01003236",757,965,208,0.215544041450777,0.0882440966389913
"S01003237",1002,1047,45,0.0429799426934097,0.644481415688704
"S01003238",677,820,143,0.174390243902439,0.147145899110606
"S01003239",926,1090,164,0.15045871559633,0.195814517760229
"S01003240",669,873,204,0.233676975945017,0.0698423334169196
"S01003241",797,876,79,0.0901826484018265,0.388635216751892
"S01003242",961,1146,185,0.161431064572426,0.171944267120927
"S01003243",788,929,141,0.151776103336921,0.192799114519081
"S01003244",928,1060,132,0.124528301886792,0.264497218660816
"S01003245",825,942,117,0.124203821656051,0.265479173903875
"S01003246",937,1057,120,0.11352885525071,0.299671909938392
"S01003247",614,814,200,0.245700245700246,0.0596265473615497
"S01003248",735,882,147,0.166666666666667,0.161505582889846
"S01003249",656,755,99,0.13112582781457,0.245227334426183
"S01003250",529,613,84,0.137030995106036,0.229061433973562
"S01003251",764,895,131,0.146368715083799,0.205448621962998
"S01003252",663,753,90,0.119521912350598,0.280017724469292
"S01003253",776,1095,319,0.291324200913242,0.0319503794878921
"S01003254",545,656,111,0.169207317073171,0.156648640092083
"S01003255",882,1023,141,0.13782991202346,0.226949648371048
"S01003256",813,1027,214,0.208373904576436,0.0966498134193191
"S01003257",760,866,106,0.122401847575058,0.270992332239861
"S01003258",862,957,95,0.0992685475444096,0.351522623211346
"S01003259",1049,1183,134,0.113271344040575,0.300543566398203
"S01003260",754,832,78,0.09375,0.373663085628984
"S01003261",948,1036,88,0.0849420849420849,0.411609907075285
"S01003262",683,866,183,0.211316397228637,0.0931168158237295
"S01003263",664,820,156,0.190243902439024,0.121211065765558
"S01003264",551,624,73,0.116987179487179,0.288184150372949
"S01003265",668,774,106,0.136950904392765,0.229274110874722
"S01003266",720,783,63,0.0804597701149425,0.432222472867462
"S01003267",881,1032,151,0.146317829457364,0.205571124345838
"S01003268",609,869,260,0.299194476409666,0.0285742711680958
"S01003269",840,998,158,0.158316633266533,0.178438041449923
"S01003270",698,875,177,0.202285714285714,0.104345493169331
"S01003271",708,967,259,0.267838676318511,0.0442657509321439
"S01003272",888,1080,192,0.177777777777778,0.141218665425476
"S01003273",692,855,163,0.190643274853801,0.120614576777544
"S01003274",1000,1185,185,0.156118143459916,0.183154037382288
"S01003275",924,1129,205,0.181576616474756,0.134828062271731
"S01003276",750,824,74,0.0898058252427184,0.390247848087604
"S01003277",630,717,87,0.121338912133891,0.274292503181214
"S01003278",782,920,138,0.15,0.196874404340723
"S01003279",527,654,127,0.194189602446483,0.115432650787691
"S01003280",893,1101,208,0.188919164396004,0.123208706780304
"S01003281",792,929,137,0.147470398277718,0.202812480142548
"S01003282",819,917,98,0.106870229007634,0.322957712935692
"S01003283",756,801,45,0.0561797752808989,0.560909498125207
"S01003284",905,1006,101,0.100397614314115,0.347141059678341
"S01003285",753,1000,247,0.247,0.05860703655823
"S01003286",939,1150,211,0.183478260869565,0.131727824398228
"S01003287",533,654,121,0.185015290519878,0.129269064834825
"S01003288",743,808,65,0.0804455445544554,0.432289343623009
"S01003289",552,645,93,0.144186046511628,0.210762640513565
"S01003290",708,832,124,0.149038461538462,0.19911286160585
"S01003291",719,803,84,0.104607721046077,0.331232887876399
"S01003292",758,812,54,0.0665024630541872,0.502495022187217
"S01003293",876,986,110,0.111561866125761,0.306388113275056
"S01003294",741,840,99,0.117857142857143,0.28535745246533
"S01003295",970,1142,172,0.15061295971979,0.195459284009083
"S01003296",625,767,142,0.185136897001304,0.129076307782634
"S01003297",501,575,74,0.128695652173913,0.25217313162126
"S01003298",1003,1148,145,0.126306620209059,0.259173414008632
"S01003299",462,557,95,0.170556552962298,0.154123124162541
"S01003300",800,878,78,0.0888382687927107,0.39441616938329
"S01003301",726,838,112,0.133651551312649,0.238191369095627
"S01003302",858,1032,174,0.168604651162791,0.157788702718927
"S01003303",670,1251,581,0.464428457234213,0.00194166780716218
"S01003304",643,922,279,0.302603036876356,0.0272145099685698
"S01003305",644,792,148,0.186868686868687,0.126359197104481
"S01003306",891,968,77,0.0795454545454545,0.436539420193863
"S01003307",1005,1130,125,0.110619469026549,0.309653635146973
"S01003308",823,974,151,0.155030800821355,0.185527709699849
"S01003309",727,870,143,0.164367816091954,0.166016625645277
"S01003310",755,848,93,0.109669811320755,0.31297596972563
"S01003311",743,838,95,0.113365155131265,0.300225758907358
"S01003312",585,695,110,0.158273381294964,0.178529757436437
"S01003313",918,1085,167,0.153917050691244,0.187987698173465
"S01003314",520,687,167,0.243085880640466,0.0617257059702767
"S01003315",528,695,167,0.240287769784173,0.0640458773657485
"S01003316",620,866,246,0.284064665127021,0.0353783826408889
"S01003317",709,864,155,0.179398148148148,0.138460191215189
"S01003318",797,883,86,0.0973952434881087,0.358902247686884
"S01003319",709,897,188,0.20958751393534,0.0951782951532489
"S01003320",537,735,198,0.269387755102041,0.0433380599644768
"S01003321",762,821,59,0.071863580998782,0.47437101202888
"S01003322",653,935,282,0.301604278074866,0.0276067768012058
"S01003323",551,691,140,0.20260492040521,0.103928704752827
"S01003324",708,906,198,0.218543046357616,0.0849279419754946
"S01003325",775,920,145,0.157608695652174,0.179944572350725
"S01003326",756,843,87,0.103202846975089,0.336466793016943
"S01003327",602,790,188,0.237974683544304,0.0660228092790747
"S01003328",426,680,254,0.373529411764706,0.00931122591616614
"S01003329",788,905,117,0.129281767955801,0.250481919571735
"S01003330",917,1049,132,0.125834127740705,0.260578436996084
"S01003331",596,668,72,0.107784431137725,0.319667123168207
"S01003332",622,718,96,0.133704735376045,0.238045186737451
"S01003333",812,1022,210,0.205479452054795,0.100242371944493
"S01003334",842,992,150,0.151209677419355,0.194090461846252
"S01003335",412,607,195,0.321252059308072,0.0207532085135546
"S01003336",914,981,67,0.0682976554536188,0.492914828704864
"S01003337",835,1007,172,0.170804369414101,0.153663262369436
"S01003338",801,999,198,0.198198198198198,0.109817177808266
"S01003339",768,871,103,0.118254879448909,0.284073452968623
"S01003340",982,1132,150,0.132508833922261,0.241351837353622
"S01003341",737,854,117,0.137002341920375,0.229137500674654
"S01003342",870,1039,169,0.162656400384986,0.169448235428582
"S01003343",598,660,62,0.0939393939393939,0.372882914523227
"S01003344",731,878,147,0.167425968109339,0.160040024988603
"S01003345",932,1131,199,0.175950486295314,0.1443886561243
"S01003346",847,953,106,0.111227701993704,0.307542469209549
"S01003347",715,867,152,0.175317185697809,0.14550216091006
"S01003348",707,1025,318,0.310243902439024,0.0243756095127554
"S01003349",854,953,99,0.103882476390346,0.333925588864783
"S01003350",672,769,97,0.126137841352406,0.259674517016198
"S01003351",884,1251,367,0.293365307753797,0.0310419898946035
"S01003352",780,935,155,0.165775401069519,0.163241252446407
"S01003353",841,976,135,0.138319672131148,0.225663739864923
"S01003354",935,1003,68,0.0677966101694915,0.495572020450191
"S01003355",773,948,175,0.184599156118143,0.129930636452164
"S01003356",867,978,111,0.113496932515337,0.299779842356811
"S01003357",948,1156,208,0.179930795847751,0.137564075088974
"S01003358",607,1015,408,0.401970443349754,0.00585095136676117
"S01003359",861,1034,173,0.167311411992263,0.160260364788358
"S01003360",748,873,125,0.143184421534937,0.213242390087563
"S01003361",714,793,79,0.0996216897856242,0.350146866846598
"S01003362",752,871,119,0.13662456946039,0.230142515572872
"S01003363",755,818,63,0.0770171149144254,0.448679760704613
"S01003364",597,765,168,0.219607843137255,0.0837778015682458
"S01003365",774,971,197,0.202883625128733,0.103566024993954
"S01003366",386,764,378,0.494764397905759,0.00108377582916182
"S01003367",948,1150,202,0.175652173913043,0.144912206692017
"S01003368",535,1074,539,0.501862197392924,0.000940795012918855
"S01003369",704,771,67,0.0869001297016861,0.402886588782921
"S01003370",596,911,315,0.345773874862788,0.014364113485704
"S01003371",653,843,190,0.225385527876631,0.0777778737572254
"S01003372",689,808,119,0.147277227722772,0.203272491970686
"S01003373",746,1115,369,0.330941704035874,0.0179737874199079
"S01003374",471,624,153,0.245192307692308,0.0600292855384945
"S01003375",722,826,104,0.12590799031477,0.26035834515617
"S01003376",596,726,130,0.179063360881543,0.139026116140841
"S01003377",746,835,89,0.106586826347305,0.323983967813577
"S01003378",855,1097,242,0.220601640838651,0.0827170183978794
"S01003379",780,1029,249,0.24198250728863,0.0626314230286819
"S01003380",652,902,250,0.277161862527716,0.0389413122097051
"S01003381",734,832,98,0.117788461538462,0.285579702115386
"S01003382",783,1040,257,0.247115384615385,0.0585172930084066
"S01003383",916,1002,86,0.0858283433133733,0.407640683741197
"S01003384",969,1074,105,0.0977653631284916,0.357433255642958
"S01003385",699,949,250,0.263435194942044,0.0470012743522884
"S01003386",657,722,65,0.0900277008310249,0.389297594243827
"S01003387",710,879,169,0.19226393629124,0.118221029356396
"S01003388",925,1104,179,0.16213768115942,0.170500867678824
"S01003389",862,1138,276,0.242530755711775,0.0621799026340121
"S01003390",914,1069,155,0.144995322731525,0.208778082843242
"S01003391",686,868,182,0.209677419354839,0.0950700900566734
"S01003392",718,867,149,0.171856978085352,0.15172371488514
"S01003393",962,1076,114,0.105947955390335,0.326308214648025
"S01003394",901,1162,261,0.224612736660929,0.0785573146216198
"S01003395",630,854,224,0.262295081967213,0.0477338855679378
"S01003396",712,912,200,0.219298245614035,0.0841107592126045
"S01003397",777,956,179,0.187238493723849,0.125785698344093
"S01003398",810,999,189,0.189189189189189,0.122799134686513
"S01003399",757,1860,1103,0.593010752688172,0.000124689347655771
"S01003400",733,822,89,0.108272506082725,0.317922724103896
"S01003401",724,884,160,0.180995475113122,0.135788506556139
"S01003402",822,973,151,0.1551901336074,0.185178163516823
"S01003403",579,879,300,0.341296928327645,0.0153778948340672
"S01003404",645,768,123,0.16015625,0.174576163848451
"S01003405",787,889,102,0.114735658042745,0.295617210020543
"S01003406",634,793,159,0.200504413619168,0.10669908758
"S01003407",697,766,69,0.0900783289817232,0.389081054867431
"S01003408",570,724,154,0.212707182320442,0.0914877390099042
"S01003409",747,1024,277,0.2705078125,0.0426782351281043
"S01003410",448,1006,558,0.554671968190855,0.000306761132750394
"S01003411",992,1183,191,0.1614539306847,0.171897387081102
"S01003412",842,1015,173,0.170443349753695,0.154333602063151
"S01003413",721,861,140,0.16260162601626,0.169559111689336
"S01003414",628,689,61,0.0885341074020319,0.395734777676576
"S01003415",819,1499,680,0.453635757171448,0.00237040573450146
"S01003416",786,958,172,0.179540709812109,0.138219834813701
"S01003417",724,891,167,0.187429854096521,0.125489856189671
"S01003418",899,1007,108,0.107249255213505,0.321589760164285
"S01003419",903,1062,159,0.149717514124294,0.19752966885965
"S01003420",923,1060,137,0.129245283018868,0.250586896590771
"S01003421",531,571,40,0.0700525394045534,0.483708955794447
"S01003422",732,842,110,0.130641330166271,0.24659819623653
"S01003423",378,647,269,0.415765069551777,0.00463313752678307
"S01003424",865,1128,263,0.233156028368794,0.0703185777462508
"S01003425",620,1042,422,0.404990403071017,0.00556211168846532
"S01003426",888,1099,211,0.191992720655141,0.118618583502632
"S01003427",892,991,99,0.0998990918264379,0.349069576343112
"S01003428",717,937,220,0.234791889007471,0.0688328335267565
"S01003429",409,1173,764,0.651321398124467,2.65615221241554e-05
"S01003430",526,907,381,0.420066152149945,0.00430313103416017
"S01003431",655,761,106,0.139290407358738,0.223134350066934
"S01003432",642,1174,532,0.453151618398637,0.00239149408789195
"S01003433",552,1253,701,0.559457302474062,0.000275346821396135
"S01003434",862,957,95,0.0992685475444096,0.351522623211346
"S01003435",853,1007,154,0.152929493545184,0.190193471801739
"S01003436",514,657,143,0.21765601217656,0.0858969007579242
"S01003437",396,827,431,0.521160822249093,0.000633719051806871
"S01003438",607,1049,442,0.421353670162059,0.00420854551914925
"S01003439",847,935,88,0.0941176470588235,0.372149975367352
"S01003440",520,590,70,0.11864406779661,0.282822085199835
"S01003441",896,1165,269,0.230901287553648,0.0724137174316818
"S01003442",725,837,112,0.133811230585424,0.237752715407859
"S01003443",900,1038,138,0.132947976878613,0.24013284114052
"S01003444",815,943,128,0.135737009544008,0.232519382014522
"S01003445",843,1048,205,0.195610687022901,0.113413021210465
"S01003446",363,606,243,0.400990099009901,0.00594757611506071
"S01003447",986,1877,891,0.474693660095898,0.00160002372801221
"S01003448",689,778,89,0.11439588688946,0.296753772857496
"S01003449",622,1061,439,0.413760603204524,0.00479457380049657
"S01003450",678,912,234,0.256578947368421,0.0515642321964077
"S01003451",599,833,234,0.280912364945978,0.0369673406779116
"S01003452",771,1348,577,0.428041543026706,0.00374666495854477
"S01003453",550,976,426,0.436475409836066,0.00322945114005624
"S01003454",560,855,295,0.345029239766082,0.0145284446369348
"S01003455",765,850,85,0.1,0.3486784401
"S01003456",653,819,166,0.202686202686203,0.103822813852558
"S01003457",812,1017,205,0.2015732546706,0.105281184673688
"S01003458",831,978,147,0.150306748466258,0.196165075595932
"S01003459",842,981,139,0.141692150866463,0.21698556395006
"S01003460",573,1096,523,0.477189781021898,0.00152559999350987
"S01003461",762,830,68,0.0819277108433735,0.425371892698485
"S01003462",587,666,79,0.118618618618619,0.282903760770769
"S01003463",669,834,165,0.197841726618705,0.110306389910133
"S01003464",575,1177,602,0.511469838572642,0.000774308128599416
"S01003465",663,969,306,0.315789473684211,0.0224852392801322
"S01003466",652,830,178,0.214457831325301,0.0894736251099889
"S01003467",726,806,80,0.0992555831265509,0.351573221881414
"S01003468",495,931,436,0.468313641245972,0.00180532409899843
"S01003469",871,1139,268,0.235294117647059,0.0683823953129502
"S01003470",610,976,366,0.375,0.00909494701772928
"S01003471",888,1094,206,0.188299817184644,0.124152776910294
"S01003472",728,846,118,0.139479905437352,0.222643572881723
"S01003473",799,1032,233,0.22577519379845,0.0773875005714644
"S01003474",510,935,425,0.454545454545455,0.0023312328394265
"S01003475",699,991,292,0.294651866801211,0.0304814212302481
"S01003476",771,858,87,0.101398601398601,0.343297706513795
"S01003477",799,1102,303,0.274954627949183,0.0401468844456956
"S01003478",615,891,276,0.30976430976431,0.0245456262694725
"S01003479",643,914,271,0.296498905908096,0.0296925688317657
"S01003480",579,734,155,0.211171662125341,0.0932878401370534
"S01003481",804,1132,328,0.289752650176678,0.0326660196489175
"S01003482",574,698,124,0.177650429799427,0.141437541180994
"S01003483",598,672,74,0.110119047619048,0.311400359311296
"S01003484",667,1243,576,0.463395012067578,0.00197946147033233
"S01003485",679,1214,535,0.440691927512356,0.00299578661066785
"S01003486",863,976,113,0.11577868852459,0.292152616707255
"S01003487",707,1197,490,0.409356725146199,0.00516716861778821
"S01003488",930,1085,155,0.142857142857143,0.214058315601308
"S01003489",923,1041,118,0.113352545629203,0.300268459006884
"S01003490",658,804,146,0.181592039800995,0.134802655851373
"S01003491",631,730,99,0.135616438356164,0.232843967759279
"S01003492",782,1063,281,0.264346190028222,0.0464231798867773
"S01003493",644,783,139,0.177522349936143,0.141657982746521
"S01003494",669,865,196,0.226589595375723,0.07657730940104
"S01003495",749,935,186,0.198930481283422,0.108818332913187
"S01003496",708,1048,340,0.324427480916031,0.0198024876185534
"S01003497",752,1117,365,0.326768128916741,0.0191269919356785
"S01003498",891,1105,214,0.193665158371041,0.116186123034083
"S01003499",792,1165,373,0.320171673819742,0.0210859203788583
"S01003500",587,711,124,0.174402250351617,0.147124501784137
"S01003501",417,854,437,0.511709601873536,0.000770516321910472
"S01003502",627,886,259,0.292325056433409,0.0315020045167883
"S01003503",500,810,310,0.382716049382716,0.00803248373043942
"S01003504",476,986,510,0.517241379310345,0.000687543812135026
"S01003505",576,737,161,0.218453188602442,0.0850256490114319
"S01003506",747,1187,440,0.370682392586352,0.00974313743349055
"S01003507",342,674,332,0.492581602373887,0.00113151963666682
"S01003508",735,888,153,0.172297297297297,0.150918935428064
"S01003509",646,980,334,0.340816326530612,0.0154904638663527
"S01003510",802,957,155,0.1619644723093,0.170853667258825
"S01003511",857,1191,334,0.280436607892527,0.0372126505272872
"S01003512",688,762,74,0.0971128608923885,0.360026666187194
"S01003513",429,964,535,0.554979253112033,0.000304650982328596
"S01003514",564,989,425,0.429726996966633,0.00363771041813899
"S01003515",724,796,72,0.0904522613065327,0.38748507983305
"S01003516",658,742,84,0.113207547169811,0.300759866478133
"S01003517",595,883,288,0.326160815402039,0.0193002360884622
"S01003518",915,1166,251,0.215265866209262,0.0885575180728174
"S01003519",601,746,145,0.194369973190349,0.115174529105052
"S01003520",588,855,267,0.312280701754386,0.0236653054045366
"S01003521",310,685,375,0.547445255474453,0.000360338962202975
"S01003522",583,1010,427,0.422772277227723,0.00410649983547678
"S01003523",541,605,64,0.105785123966942,0.326902998800951
"S01003524",895,1207,312,0.258492129246065,0.0502524976788351
"S01003525",757,1146,389,0.339441535776614,0.0158165813236741
"S01003526",670,1170,500,0.427350427350427,0.00379218407012477
"S01003527",861,969,108,0.111455108359133,0.306756478861783
"S01003528",576,649,73,0.112480739599384,0.303233980051956
"S01003529",458,589,131,0.222410865874363,0.0808168338542877
"S01003530",587,959,372,0.387904066736184,0.00738235525859411
"S01003531",699,882,183,0.207482993197279,0.0977430543650877
"S01003532",999,1125,126,0.112,0.304880506868562
"S01003533",644,829,185,0.223160434258142,0.0800411589041233
"S01003534",837,1077,240,0.222841225626741,0.0803706622586314
"S01003535",673,875,202,0.230857142857143,0.0724552921648983
"S01003536",861,1207,346,0.286661143330572,0.0341160556032323
"S01003537",706,890,184,0.206741573033708,0.0986613250962744
"S01003538",625,705,80,0.113475177304965,0.299853417892373
"S01003539",857,1059,202,0.190745986779981,0.12046159747044
"S01003540",880,1051,171,0.162702188392008,0.169355599764025
"S01003541",740,974,234,0.240246406570842,0.0640807562624505
"S01003542",697,1013,316,0.311944718657453,0.0237811760175639
"S01003543",682,805,123,0.152795031055901,0.190495597341438
"S01003544",435,682,247,0.36217008797654,0.0111441980858796
"S01003545",718,1195,477,0.399163179916318,0.00613148103890713
"S01003546",868,1100,232,0.210909090909091,0.0935988257239936
"S01003547",644,922,278,0.301518438177874,0.027640727095249
"S01003548",457,597,140,0.234505862646566,0.0690905562801989
"S01003549",731,849,118,0.138987043580683,0.22392205294363
"S01003550",671,754,83,0.110079575596817,0.311538513247728
"S01003551",699,801,102,0.127340823970037,0.256121830236485
"S01003552",654,1079,425,0.393883225208526,0.00669210946761547
"S01003553",647,729,82,0.112482853223594,0.303226758622048
"S01003554",584,905,321,0.354696132596685,0.0125211056223218
"S01003555",597,1018,421,0.413555992141454,0.00481133427549597
"S01003556",669,789,120,0.152091254752852,0.192083979918218
"S01003557",725,861,136,0.157955865272938,0.179204351514599
"S01003558",800,1136,336,0.295774647887324,0.0299996754374043
"S01003559",810,954,144,0.150943396226415,0.194700219774751
"S01003560",928,1112,184,0.165467625899281,0.163844508428913
"S01003561",885,1111,226,0.203420342034203,0.102870800076819
"S01003562",602,776,174,0.224226804123711,0.0789491938880228
"S01003563",559,646,87,0.134674922600619,0.235392650427907
"S01003564",826,1122,296,0.263814616755793,0.046759720224611
"S01003565",800,920,120,0.130434782608696,0.247184706121866
"S01003566",536,931,395,0.424274973147154,0.00400083911119953
"S01003567",812,1002,190,0.189620758483034,0.122147076551493
"S01003568",671,923,252,0.273022751895991,0.0412295117140069
"S01003569",695,774,79,0.102067183462532,0.340752020025194
"S01003570",696,838,142,0.16945107398568,0.156189634927524
"S01003571",802,975,173,0.177435897435897,0.141806953130804
"S01003572",920,1090,170,0.155963302752294,0.183490377454776
"S01003573",870,974,104,0.106776180698152,0.323297954911438
"S01003574",722,1150,428,0.372173913043478,0.0095146665392458
"S01003575",818,946,128,0.135306553911205,0.233680069265412
"S01003576",665,1096,431,0.393248175182482,0.00676255657726246
"S01003577",701,863,162,0.187717265353418,0.125046696368964
"S01003578",485,567,82,0.144620811287478,0.209694382877312
"S01003579",477,707,230,0.325318246110325,0.0195429289193436
"S01003580",869,1054,185,0.175521821631879,0.145141516252552
"S01003581",790,2339,1549,0.662248824283882,1.93182906023971e-05
"S01003582",579,748,169,0.225935828877005,0.0772270878958865
"S01003583",546,634,88,0.138801261829653,0.224405681523214
"S01003584",635,754,119,0.157824933687003,0.179483195978867
"S01003585",512,622,110,0.176848874598071,0.142822214564731
"S01003586",774,960,186,0.19375,0.11606393119265
"S01003587",1005,1123,118,0.105075690115761,0.329505793513318
"S01003588",672,754,82,0.108753315649867,0.316212673347189
"S01003589",940,1518,578,0.380764163372859,0.00829012006427356
"S01003590",674,868,194,0.223502304147465,0.0796896122367388
"S01003591",885,1286,401,0.311819595645412,0.0238244575477474
"S01003592",886,1140,254,0.22280701754386,0.080406045902302
"S01003593",789,938,149,0.158848614072495,0.177313437065272
"S01003594",883,1100,217,0.197272727272727,0.111091334594784
"S01003595",872,1064,192,0.180451127819549,0.136693722241235
"S01003596",682,824,142,0.172330097087379,0.150859140688282
"S01003597",592,673,81,0.12035661218425,0.277374431415716
"S01003598",695,746,51,0.0683646112600536,0.492560715192465
"S01003599",607,718,111,0.154596100278552,0.18648438314594
"S01003600",833,949,116,0.122233930453109,0.271511287895282
"S01003601",798,919,121,0.131664853101197,0.243710252502164
"S01003602",710,747,37,0.0495314591700134,0.601696477526901
"S01003603",743,915,172,0.187978142076503,0.124645670162369
"S01003604",704,962,258,0.268191268191268,0.044053038740909
"S01003605",591,719,128,0.178025034770515,0.140794569745624
"S01003606",826,952,126,0.132352941176471,0.241785910264515
"S01003607",510,586,76,0.129692832764505,0.249301907118942
"S01003608",509,568,59,0.10387323943662,0.333960010670039
"S01003609",937,1146,209,0.182373472949389,0.1335210480381
"S01003610",660,836,176,0.210526315789474,0.0940538507296812
"S01003611",801,923,122,0.132177681473456,0.242274748038151
"S01003612",702,1065,363,0.340845070422535,0.015483710530713
"S01003613",763,927,164,0.176914778856526,0.142707907466583
"S01003614",525,610,85,0.139344262295082,0.222994773334777
"S01003615",443,581,138,0.237521514629948,0.0664164927822274
"S01003616",602,793,191,0.240857503152585,0.0635671937498963
"S01003617",864,1033,169,0.163601161665053,0.167546056194698
"S01003618",708,826,118,0.142857142857143,0.214058315601308
"S01003619",820,939,119,0.126730564430245,0.25791856343196
"S01003620",844,1048,204,0.194656488549618,0.11476557575219
"S01003621",933,1002,69,0.0688622754491018,0.489935853351507
"S01003622",726,831,105,0.126353790613718,0.259033521165861
"S01003623",887,1010,123,0.121782178217822,0.272911892152394
"S01003624",1009,1125,116,0.103111111111111,0.336811132691989
"S01003625",689,942,253,0.268577494692144,0.0438210915342027
"S01003626",837,941,104,0.110520722635494,0.309997610077822
"S01003627",546,642,96,0.149532710280374,0.197959407991189
"S01003628",669,771,102,0.132295719844358,0.241945415427682
"S01003629",769,839,70,0.0834326579261025,0.418450209596482
"S01003630",708,805,97,0.120496894409938,0.276932402395764
"S01003631",671,790,119,0.150632911392405,0.195413376463148
"S01003632",592,864,272,0.314814814814815,0.0228076028744676
"S01003633",838,1033,195,0.188770571151985,0.123434616226468
"S01003634",1042,1184,142,0.119932432432432,0.278714886653021
"S01003635",486,642,156,0.242990654205607,0.061803406301223
"S01003636",914,1065,151,0.141784037558685,0.216753380552073
"S01003637",704,861,157,0.182346109175377,0.133565740693751
"S01003638",675,851,176,0.206815511163337,0.0985694032882371
"S01003639",739,837,98,0.117084826762246,0.287865622747975
"S01003640",904,1017,113,0.111111111111111,0.307946147657439
"S01003641",688,820,132,0.160975609756098,0.172880439726709
"S01003642",782,888,106,0.119369369369369,0.280503234057642
"S01003643",744,924,180,0.194805194805195,0.114553837718008
"S01003644",808,952,144,0.151260504201681,0.193974269006478
"S01003645",529,594,65,0.109427609427609,0.31382842015705
"S01003646",753,926,173,0.18682505399568,0.126427018208326
"S01003647",661,761,100,0.131406044678055,0.244437609108713
"S01003648",671,936,265,0.283119658119658,0.0358481472079344
"S01003649",980,1144,164,0.143356643356643,0.212814155663653
"S01003650",645,790,145,0.183544303797468,0.131621317430819
"S01003651",716,794,78,0.0982367758186398,0.355570071288525
"S01003652",578,681,103,0.151248164464024,0.194002472574364
"S01003653",731,833,102,0.122448979591837,0.270846829098411
"S01003654",997,1169,172,0.147134302822926,0.203613454170342
"S01003655",906,985,79,0.0802030456852792,0.433430702531828
"S01003656",531,609,78,0.12807881773399,0.253964073551147
"S01003657",853,1000,147,0.147,0.20393431650419
"S01003658",848,969,121,0.124871001031992,0.263463679031665
"S01003659",767,959,192,0.200208550573514,0.107094598694069
"S01003660",694,906,212,0.233995584988962,0.0695524972550347
"S01003661",727,921,194,0.210640608034745,0.0939177774737834
"S01003662",559,667,108,0.16191904047976,0.170946313552845
"S01003663",693,836,143,0.171052631578947,0.153203812081305
"S01003664",509,618,109,0.176375404530744,0.143645846346346
"S01003665",596,709,113,0.159379407616361,0.17619770427208
"S01003666",701,803,102,0.127023661270237,0.257054213433339
"S01003667",853,982,129,0.131364562118126,0.244554373416971
"S01003668",692,861,169,0.196283391405343,0.112468118557472
"S01003669",547,598,51,0.0852842809364548,0.410073234178648
"S01003670",840,999,159,0.159159159159159,0.176659899224899
"S01003671",651,739,88,0.119079837618403,0.281426831898363
"S01003672",800,967,167,0.172699069286453,0.150187963724414
"S01003673",638,880,242,0.275,0.0401217683124734
"S01003674",777,871,94,0.107921928817451,0.319174831611986
"S01003675",611,778,167,0.214652956298201,0.0892516251015027
"S01003676",662,770,108,0.14025974025974,0.220634103657904
"S01003677",750,830,80,0.0963855421686747,0.362937388667848
"S01003678",659,755,96,0.127152317880795,0.256675625859612
"S01003679",991,1141,150,0.131463628396144,0.244275606738535
"S01003680",786,1021,235,0.230166503428012,0.0731085279685344
"S01003681",552,622,70,0.112540192926045,0.303030910258667
"S01003682",1025,1169,144,0.123182207014542,0.268592290188694
"S01003683",623,699,76,0.108726752503577,0.316306931539611
"S01003684",697,801,104,0.129837702871411,0.248887233382801
"S01003685",497,581,84,0.144578313253012,0.209798589197744
"S01003686",919,1135,216,0.190308370044053,0.121114599827107
"S01003687",617,762,145,0.190288713910761,0.121144004908173
"S01003688",894,994,100,0.100603621730382,0.346346931242776
"S01003689",573,672,99,0.147321428571429,0.203167150334915
"S01003690",908,1011,103,0.101879327398615,0.341465577093719
"S01003691",1047,1160,113,0.0974137931034483,0.358828495771258
"S01003692",940,1075,135,0.125581395348837,0.261332783050246
"S01003693",595,654,59,0.0902140672782875,0.388501029549187
"S01003694",843,947,104,0.109820485744456,0.312446710157788
"S01003695",855,1214,359,0.295716639209226,0.0300243960288571
"S01003696",994,1201,207,0.172356369691923,0.150811260531869
"S01003697",963,1030,67,0.0650485436893204,0.510376446959496
"S01003698",899,961,62,0.0645161290322581,0.513290280463509
"S01003699",959,1121,162,0.144513826940232,0.209956800383224
"S01003700",988,1086,98,0.0902394106813996,0.388392820533075
"S01003701",905,1025,120,0.117073170731707,0.287903628322396
"S01003702",780,911,131,0.143798024149286,0.211720181280912
"S01003703",988,1161,173,0.14900947459087,0.1991806973261
"S01003704",677,760,83,0.109210526315789,0.314594238052132
"S01003705",812,950,138,0.145263157894737,0.208124994571755
"S01003706",701,830,129,0.155421686746988,0.184671235993765
"S01003707",906,1057,151,0.142857142857143,0.214058315601308
"S01003708",604,796,192,0.241206030150754,0.0632759550455896
"S01003709",817,1060,243,0.229245283018868,0.0739881064413394
"S01003710",827,960,133,0.138541666666667,0.225083036357592
"S01003711",801,975,174,0.178461538461538,0.140048674850528
"S01003712",869,1031,162,0.157129000969932,0.180971885680007
"S01003713",643,886,243,0.274266365688488,0.0405296179930661
"S01003714",841,965,124,0.128497409326425,0.252747474388321
"S01003715",573,884,311,0.351809954751131,0.0130925297538083
"S01003716",732,898,166,0.184855233853007,0.129523163720565
"S01003717",765,928,163,0.175646551724138,0.144922090248204
"S01003718",657,795,138,0.173584905660377,0.148587545613127
"S01003719",508,608,100,0.164473684210526,0.16580641532471
"S01003720",861,960,99,0.103125,0.336758979002868
"S01003721",679,819,140,0.170940170940171,0.153411785730671
"S01003722",857,995,138,0.138693467336683,0.224686723809079
"S01003723",488,594,106,0.178451178451178,0.14006633669021
"S01003724",736,890,154,0.173033707865169,0.149581566446687
"S01003725",547,658,111,0.168693009118541,0.157621090264979
"S01003726",594,766,172,0.224543080939948,0.0786279139108099
"S01003727",690,788,98,0.124365482233503,0.264989540743909
"S01003728",489,540,51,0.0944444444444444,0.370809620329065
"S01003729",643,776,133,0.17139175257732,0.152578210378934
"S01003730",584,703,119,0.16927453769559,0.156521939578987
"S01003731",487,651,164,0.251920122887865,0.0548882932307983
"S01003732",755,886,131,0.147855530474041,0.201898130435408
"S01003733",776,898,122,0.135857461024499,0.232195525207444
"S01003734",681,752,71,0.0944148936170213,0.370930643719483
"S01003735",660,783,123,0.157088122605364,0.181059674315273
"S01003736",795,896,101,0.112723214285714,0.302406547475643
"S01003737",590,674,84,0.124629080118694,0.264192905471492
"S01003738",623,720,97,0.134722222222222,0.235264013857649
"S01003739",477,576,99,0.171875,0.151690700248627
"S01003740",515,621,106,0.170692431561997,0.153870827240491
"S01003741",767,946,179,0.189217758985201,0.122755871943315
"S01003742",454,567,113,0.199294532627866,0.108324810918024
"S01003743",517,624,107,0.171474358974359,0.152426168887525
"S01003744",537,642,105,0.163551401869159,0.167645760899105
"S01003745",769,829,60,0.0723763570566948,0.471756717030459
"S01003746",754,841,87,0.103448275862069,0.335547108486829
"S01003747",921,1038,117,0.11271676300578,0.302428535801675
"S01003748",527,650,123,0.189230769230769,0.122736175301744
"S01003749",757,877,120,0.136830102622577,0.229595230153029
"S01003750",546,667,121,0.181409295352324,0.135103962853038
"S01003751",785,1036,251,0.242277992277992,0.0623877054932972
"S01003752",703,858,155,0.180652680652681,0.136357921199391
"S01003753",848,982,134,0.136456211812627,0.230591685987149
"S01003754",825,947,122,0.12882787750792,0.251790705945952
"S01003755",652,817,165,0.201958384332925,0.104774450544315
"S01003756",666,762,96,0.125984251968504,0.260131280223161
"S01003757",568,624,56,0.0897435897435897,0.390514766341446
"S01003758",707,799,92,0.11514392991239,0.294256689598128
"S01003759",576,647,71,0.109737248840804,0.312738988762061
"S01003760",715,800,85,0.10625,0.325207496456734
"S01003761",765,890,125,0.140449438202247,0.220147767202443
"S01003762",749,901,152,0.168701442841287,0.157605100120516
"S01003763",850,986,136,0.137931034482759,0.226683603446804
"S01003764",805,920,115,0.125,0.263075576163828
"S01003765",683,788,105,0.133248730964467,0.239301192003391
"S01003766",532,695,163,0.234532374100719,0.0690666317903184
"S01003767",559,775,216,0.278709677419355,0.0381154502002462
"S01003768",537,615,78,0.126829268292683,0.257627191572379
"S01003769",580,706,126,0.178470254957507,0.140033816441765
"S01003770",576,653,77,0.11791730474732,0.28516289921573
"S01003771",603,751,148,0.197070572569907,0.111371418551849
"S01003772",518,617,99,0.160453808752026,0.173958621336567
"S01003773",659,759,100,0.131752305665349,0.243464916010863
"S01003774",586,708,122,0.172316384180791,0.150884137024862
"S01003775",725,828,103,0.1243961352657,0.264896791391232
"S01003776",537,618,81,0.131067961165049,0.245390703741153
"S01003777",867,991,124,0.125126135216953,0.262696586707532
"S01003778",412,559,147,0.262969588550984,0.0472992311650176
"S01003779",519,580,61,0.105172413793103,0.329149835860338
"S01003780",893,1044,151,0.14463601532567,0.20965711348323
"S01003781",589,728,139,0.190934065934066,0.120181924653087
"S01003782",502,621,119,0.191626409017713,0.11915744150969
"S01003783",930,1158,228,0.196891191709845,0.111620481503539
"S01003784",473,668,195,0.291916167664671,0.0316844944939232
"S01003785",750,910,160,0.175824175824176,0.144610128059448
"S01003786",877,991,114,0.115035317860747,0.294618075848159
"S01003787",580,679,99,0.14580265095729,0.206815075476502
"S01003788",657,773,116,0.15006468305304,0.196724638721356
"S01003789",490,557,67,0.120287253141831,0.27759321612834
"S01003790",576,673,97,0.144130757800892,0.210898840476895
"S01003791",507,734,227,0.309264305177112,0.0247240147590403
"S01003792",591,762,171,0.224409448818898,0.0787635161143587
"S01003793",494,614,120,0.195439739413681,0.113654275490155
"S01003794",610,782,172,0.219948849104859,0.083412438856397
"S01003795",546,618,72,0.116504854368932,0.289762163854388
"S01003796",564,755,191,0.252980132450331,0.0541154810696266
"S01003797",866,1026,160,0.155945419103314,0.183529259536671
"S01003798",744,912,168,0.184210526315789,0.130551231278288
"S01003799",781,926,145,0.15658747300216,0.182137961642145
"S01003800",622,793,171,0.215636822194199,0.0881397823483761
"S01003801",759,870,111,0.127586206896552,0.255402552187588
"S01003802",721,838,117,0.139618138424821,0.222286179158488
"S01003803",598,693,95,0.137085137085137,0.228917763244715
"S01003804",563,681,118,0.173274596182085,0.149146418641737
"S01003805",866,1159,293,0.252804141501294,0.0542431073671732
"S01003806",612,719,107,0.148817802503477,0.199629775158927
"S01003807",864,1020,156,0.152941176470588,0.190167241656516
"S01003808",612,744,132,0.17741935483871,0.141835474526365
"S01003809",716,843,127,0.150652431791222,0.19536847064308
"S01003810",822,960,138,0.14375,0.211838964565995
"S01003811",616,766,150,0.195822454308094,0.113114798269611
"S01003812",815,969,154,0.158926728586171,0.17714884165034
"S01003813",839,1015,176,0.173399014778325,0.148922111684311
"S01003814",704,842,138,0.163895486935867,0.166957401349657
"S01003815",586,808,222,0.274752475247525,0.0402589600706433
"S01003816",728,915,187,0.204371584699454,0.101648939604871
"S01003817",850,989,139,0.140546006066734,0.21990056295306
"S01003818",775,890,115,0.129213483146067,0.250678425708793
"S01003819",562,656,94,0.143292682926829,0.212973104647911
"S01003820",815,1139,324,0.284460052677788,0.0351834843156396
"S01003821",784,900,116,0.128888888888889,0.251614423236671
"S01003822",549,913,364,0.3986856516977,0.00618038698306309
"S01003823",826,1014,188,0.185404339250493,0.128653297850306
"S01003824",572,801,229,0.285892634207241,0.0344853888279216
"S01003825",316,674,358,0.531157270029674,0.000513182526847875
"S01003826",645,797,152,0.190715181932246,0.120507459916799
"S01003827",781,946,165,0.174418604651163,0.147095360429258
"S01003828",555,750,195,0.26,0.0492399039735588
"S01003829",644,716,72,0.100558659217877,0.346520115528844
"S01003830",804,1017,213,0.209439528023599,0.0953566440516327
"S01003831",575,683,108,0.158125915080527,0.178842779174084
"S01003832",705,933,228,0.244372990353698,0.0606840744438719
"S01003833",501,694,193,0.278097982708934,0.0384399269894647
"S01003834",626,739,113,0.152909336941813,0.190238734443764
"S01003835",475,587,112,0.190800681431005,0.120380206443205
"S01003836",452,700,248,0.354285714285714,0.0126009691399726
"S01003837",690,817,127,0.155446756425949,0.184616427219066
"S01003838",501,669,168,0.251121076233184,0.0554773976663259
"S01003839",576,762,186,0.244094488188976,0.0609081096403519
"S01003840",639,785,146,0.185987261146497,0.127735618184382
"S01003841",500,609,109,0.178981937602627,0.139164068516371
"S01003842",536,626,90,0.143769968051118,0.211789568158441
"S01003843",589,679,90,0.132547864506627,0.241243269144579
"S01003844",723,847,124,0.146399055489965,0.205375611544366
"S01003845",796,1112,316,0.284172661870504,0.0353250516010349
"S01003846",742,839,97,0.115613825983313,0.292697790792461
"S01003847",545,618,73,0.118122977346278,0.284498690583594
"S01003848",686,818,132,0.161369193154034,0.172071173426496
"S01003849",655,893,238,0.266517357222844,0.0450711263073837
"S01003850",482,632,150,0.237341772151899,0.0665732255548733
"S01003851",808,917,109,0.11886586695747,0.28211114983368
"S01003852",497,625,128,0.2048,0.101102923506281
"S01003853",567,933,366,0.392282958199357,0.00687090828469897
"S01003854",529,652,123,0.188650306748466,0.12361772962427
"S01003855",899,1114,215,0.192998204667864,0.117150732643424
"S01003856",650,832,182,0.21875,0.08470329472543
"S01003857",686,802,116,0.144638403990025,0.209651258733798
"S01003858",578,694,116,0.167146974063401,0.16057712562467
"S01003859",508,617,109,0.176661264181524,0.143148065221861
"S01003860",589,756,167,0.220899470899471,0.082401476356495
"S01003861",672,897,225,0.250836120401338,0.0556888564746224
"S01003862",527,704,177,0.251420454545455,0.0552560149759619
"S01003863",692,817,125,0.152998776009792,0.190037968528883
"S01003864",831,964,133,0.137966804979253,0.226589561421362
"S01003865",747,901,154,0.170921198668147,0.153446896222974
"S01003866",763,912,149,0.163377192982456,0.167995247629481
"S01003867",925,1061,136,0.12818096135721,0.253666717088751
"S01003868",583,704,121,0.171875,0.151690700248627
"S01003869",629,705,76,0.107801418439716,0.319606265490781
"S01003870",711,860,149,0.173255813953488,0.149180306417824
"S01003871",746,845,99,0.117159763313609,0.287621392944092
"S01003872",765,907,142,0.156560088202867,0.182197108740384
"S01003873",889,1045,156,0.149282296650718,0.198543057335142
"S01003874",643,843,200,0.237247924080664,0.0666551918849662
"S01003875",489,564,75,0.132978723404255,0.240047701237792
"S01003876",588,717,129,0.179916317991632,0.13758836317477
"S01003877",516,588,72,0.122448979591837,0.270846829098411
"S01003878",893,1079,186,0.172381835032437,0.150764864616252
"S01003879",558,680,122,0.179411764705882,0.13843721770605
"S01003880",833,934,101,0.10813704496788,0.318406006479038
"S01003881",703,800,97,0.12125,0.274570187493416
"S01003882",443,560,117,0.208928571428571,0.0959747505857422
"S01003883",495,588,93,0.158163265306122,0.178763450390447
"S01003884",723,805,82,0.101863354037267,0.341526312691633
"S01003885",615,741,126,0.17004048582996,0.155084744168844
"S01003886",523,632,109,0.17246835443038,0.150607328795546
"S01003887",822,928,106,0.114224137931034,0.297329782531492
"S01003888",548,720,172,0.238888888888889,0.0652349930618387
"S01003889",527,641,114,0.177847113884555,0.141099624156705
"S01003890",612,690,78,0.11304347826087,0.301316777470598
"S01003891",737,840,103,0.122619047619048,0.270322389665279
"S01003892",582,693,111,0.16017316017316,0.17454101629044
"S01003893",564,697,133,0.190817790530846,0.120354756582148
"S01003894",721,928,207,0.223060344827586,0.0801443452093514
"S01003895",648,741,93,0.125506072874494,0.261557982556512
"S01003896",632,730,98,0.134246575342466,0.236560473944205
"S01003897",611,723,112,0.154910096818811,0.185792906798765
"S01003898",691,836,145,0.173444976076555,0.148839327592022
"S01003899",619,757,138,0.182298546895641,0.133643455168555
"S01003900",595,799,204,0.25531914893617,0.0524447312390551
"S01003901",560,632,72,0.113924050632911,0.298338627364604
"S01003902",833,979,146,0.149131767109295,0.198894647570691
"S01003903",610,713,103,0.144460028050491,0.210088873117493
"S01003904",591,775,184,0.23741935483871,0.0665055338181178
"S01003905",768,919,151,0.164309031556039,0.166133450971866
"S01003906",662,772,110,0.142487046632124,0.21498437221301
"S01003907",679,836,157,0.187799043062201,0.124920860865062
"S01003908",769,894,125,0.139821029082774,0.221762551652189
"S01003909",620,752,132,0.175531914893617,0.145123749007147
"S01003910",655,781,126,0.161331626120359,0.172148269411133
"S01003911",568,647,79,0.12210200927357,0.271919623607722
"S01003912",612,732,120,0.163934426229508,0.166879661774604
"S01003913",683,809,126,0.1557478368356,0.183959330650505
"S01003914",827,958,131,0.136743215031315,0.229826447847046
"S01003915",603,680,77,0.113235294117647,0.300665774637481
"S01003916",710,834,124,0.148681055155875,0.199950723911378
"S01003917",808,955,147,0.153926701570681,0.187966256381136
"S01003918",815,980,165,0.168367346938776,0.158239656124312
"S01003919",544,647,103,0.15919629057187,0.176581901963863
"S01003920",584,690,106,0.153623188405797,0.188641640149362
"S01003921",712,834,122,0.146282973621103,0.205655074443039
"S01003922",756,913,157,0.171960569550931,0.151534032218414
"S01003923",718,846,128,0.151300236406619,0.193883482586231
"S01003924",473,553,80,0.144665461121157,0.209584950470379
"S01003925",713,826,113,0.13680387409201,0.2296650051652
"S01003926",581,688,107,0.155523255813953,0.184449270340323
"S01003927",604,726,122,0.168044077134986,0.158855837744182
"S01003928",826,957,131,0.136886102403344,0.229446319381122
"S01003929",473,530,57,0.107547169811321,0.320518211993758
"S01003930",709,792,83,0.10479797979798,0.33052973538726
"S01003931",826,981,155,0.158002038735984,0.179106109110556
"S01003932",833,955,122,0.127748691099476,0.254927271797961
"S01003933",606,665,59,0.0887218045112782,0.394920600426356
"S01003934",832,1008,176,0.174603174603175,0.146766839379945
"S01003935",698,849,151,0.177856301531213,0.14108385691533
"S01003936",800,952,152,0.159663865546218,0.175602375277672
"S01003937",739,855,116,0.135672514619883,0.232692955995655
"S01003938",478,596,118,0.197986577181208,0.110107364781864
"S01003939",526,638,112,0.175548589341693,0.145094401137398
"S01003940",789,961,172,0.1789802289282,0.139166964778012
"S01003941",512,634,122,0.192429022082019,0.117979630301994
"S01003942",651,821,170,0.207064555420219,0.0982603517520767
"S01003943",614,728,114,0.156593406593407,0.182125148244589
"S01003944",589,680,91,0.133823529411765,0.237718959572682
"S01003945",637,746,109,0.146112600536193,0.206065861284752
"S01003946",765,893,128,0.143337066069429,0.212862796119569
"S01003947",461,565,104,0.184070796460177,0.130775014153457
"S01003948",574,678,104,0.153392330383481,0.189156811734723
"S01003949",511,628,117,0.186305732484076,0.127236748990346
"S01003950",600,703,103,0.14651493598862,0.205096974378629
"S01003951",492,587,95,0.161839863713799,0.171107881856173
"S01003952",487,541,54,0.099815157116451,0.349395221513632
"S01003953",541,617,76,0.123176661264182,0.268609278760301
"S01003954",492,585,93,0.158974358974359,0.177048546961701
"S01003955",607,747,140,0.187416331994645,0.125510740709064
"S01003956",506,671,165,0.245901639344262,0.0594675390884434
"S01003957",620,722,102,0.141274238227147,0.218044390988062
"S01003958",717,826,109,0.131961259079903,0.242879624887017
"S01003959",686,785,99,0.126114649681529,0.259743440989471
"S01003960",805,949,144,0.151738672286617,0.192884211232735
"S01003961",532,594,62,0.104377104377104,0.33208699866883
"S01003962",542,622,80,0.128617363344051,0.252399806994778
"S01003963",484,564,80,0.141843971631206,0.216602056973538
"S01003964",506,562,56,0.099644128113879,0.350059616529501
"S01003965",510,585,75,0.128205128205128,0.253596409375097
"S01003966",845,988,143,0.144736842105263,0.209410109372178
"S01003967",475,548,73,0.133211678832117,0.239403508845564
"S01003968",861,932,71,0.0761802575107296,0.45276452428998
"S01003969",703,824,121,0.146844660194175,0.204306005725904
"S01003970",560,626,66,0.105431309904153,0.328198761578072
"S01003971",609,703,94,0.13371266002845,0.238023411855537
"S01003972",601,661,60,0.0907715582450832,0.386126959426635
"S01003973",496,579,83,0.143350604490501,0.212829158371122
"S01003974",751,870,119,0.136781609195402,0.229724250810621
"S01003975",622,703,81,0.115220483641536,0.294002211161324
"S01003976",663,767,104,0.135593220338983,0.232906519026958
"S01003977",548,677,129,0.190546528803545,0.120758830384793
"S01003978",563,657,94,0.143074581430746,0.213515915494705
"S01003979",583,686,103,0.150145772594752,0.196537030753878
"S01003980",535,589,54,0.0916808149405773,0.382282900380203
"S01003981",523,634,111,0.175078864353312,0.145923188231145
"S01003982",653,787,134,0.170266836086404,0.154662308842267
"S01003983",683,795,112,0.140880503144654,0.219046213509633
"S01003984",582,741,159,0.214574898785425,0.0893403741041422
"S01003985",778,956,178,0.186192468619247,0.127413969808181
"S01003986",541,622,81,0.130225080385852,0.247781458032885
"S01003987",491,559,68,0.121645796064401,0.27333600484794
"S01003988",473,559,86,0.153846153846154,0.188145280374965
"S01003989",729,859,130,0.151338766006985,0.193795480592026
"S01003990",472,531,59,0.111111111111111,0.307946147657439
"S01003991",546,641,95,0.148205928237129,0.201069469394449
"S01003992",859,972,113,0.116255144032922,0.290582187662171
"S01003993",579,722,143,0.198060941828255,0.110005313127366
"S01003994",638,724,86,0.11878453038674,0.282371671887069
"S01003995",805,955,150,0.157068062827225,0.181102767857767
"S01003996",489,540,51,0.0944444444444444,0.370809620329065
"S01003997",880,1036,156,0.150579150579151,0.195537098879181
"S01003998",534,648,114,0.175925925925926,0.144431696188408
"S01003999",828,945,117,0.123809523809524,0.266676829232971
"S01004000",725,808,83,0.102722772277228,0.338272316870247
"S01004001",757,848,91,0.107311320754717,0.32136625545751
"S01004002",786,956,170,0.177824267782427,0.141138838025628
"S01004003",501,595,94,0.157983193277311,0.179146200380498
"S01004004",744,860,116,0.134883720930233,0.234825276848727
"S01004005",563,694,131,0.188760806916427,0.123449474044841
"S01004006",528,631,103,0.163232963549921,0.168285087502767
"S01004007",540,620,80,0.129032258064516,0.251200617847236
"S01004008",618,662,44,0.0664652567975831,0.50269533672027
"S01004009",560,668,108,0.161676646706587,0.171441376624548
"S01004010",712,836,124,0.148325358851675,0.200787726362131
"S01004011",997,1190,193,0.16218487394958,0.170404857005904
"S01004012",680,779,99,0.127086007702182,0.256870688832587
"S01004013",495,565,70,0.123893805309735,0.266420421551721
"S01004014",619,721,102,0.141470180305132,0.217547372841146
"S01004015",873,1008,135,0.133928571428571,0.237430832876428
"S01004016",559,628,69,0.109872611464968,0.312263800769966
"S01004017",859,1069,210,0.19644527595884,0.112241790554313
"S01004018",656,915,259,0.283060109289618,0.03587793618712
"S01004019",442,532,90,0.169172932330827,0.156713485709137
"S01004020",724,830,106,0.127710843373494,0.255037908509958
"S01004021",702,847,145,0.171192443919717,0.152945610722663
"S01004022",576,679,103,0.151693667157585,0.192986571806859
"S01004023",578,626,48,0.0766773162939297,0.450334326505343
"S01004024",833,1018,185,0.181728880157171,0.134577431132639
"S01004025",797,949,152,0.160168598524763,0.174550496985396
"S01004026",630,709,79,0.111424541607898,0.306862022213936
"S01004027",719,850,131,0.154117647058824,0.187542476549098
"S01004028",741,837,96,0.114695340501792,0.295751870385035
"S01004029",879,982,103,0.104887983706721,0.330197570002165
"S01004030",778,902,124,0.137472283813747,0.227892794802017
"S01004031",559,642,83,0.129283489096573,0.250476968362564
"S01004032",525,640,115,0.1796875,0.137972741648599
"S01004033",893,1048,155,0.147900763358779,0.201790986000705
"S01004034",760,850,90,0.105882352941176,0.326547727413754
"S01004035",703,793,90,0.113493064312736,0.299792923326051
"S01004036",666,747,81,0.108433734939759,0.317348371143541
"S01004037",674,743,69,0.0928667563930013,0.377320870533319
"S01004038",676,771,95,0.123216601815824,0.268486948486459
"S01004039",754,894,140,0.156599552572707,0.182111877057294
"S01004040",677,826,149,0.180387409200969,0.136800036622275
"S01004041",642,746,104,0.13941018766756,0.222824020424985
"S01004042",636,846,210,0.24822695035461,0.057659055773964
"S01004043",735,867,132,0.152249134948097,0.191726620016789
"S01004044",665,798,133,0.166666666666667,0.161505582889846
"S01004045",616,683,67,0.0980966325036603,0.356123050502785
"S01004046",546,639,93,0.145539906103286,0.207452104772853
"S01004047",676,808,132,0.163366336633663,0.168017048630979
"S01004048",842,1011,169,0.167161226508408,0.160549648502677
"S01004049",775,923,148,0.160346695557963,0.174180693276534
"S01004050",740,853,113,0.132473622508792,0.241449819812681
"S01004051",632,723,91,0.125864453665284,0.2604880531369
"S01004052",715,809,94,0.11619283065513,0.290787143922531
"S01004053",880,981,101,0.102956167176351,0.337393450434243
"S01004054",906,1006,100,0.099403578528827,0.350996001904346
"S01004055",866,1032,166,0.160852713178295,0.173133834318016
"S01004056",745,811,66,0.0813810110974106,0.427911723850741
"S01004057",849,1069,220,0.205799812909261,0.0998389144679496
"S01004058",777,873,96,0.109965635738832,0.311937617610679
"S01004059",560,652,92,0.141104294478528,0.2184762902066
"S01004060",846,1036,190,0.183397683397683,0.131857876169832
"S01004061",721,910,189,0.207692307692308,0.0974852082972262
"S01004062",881,1001,120,0.11988011988012,0.278880603335226
"S01004063",821,988,167,0.169028340080972,0.15698643432278
"S01004064",644,731,87,0.119015047879617,0.281633883655881
"S01004065",787,1020,233,0.22843137254902,0.0747731378158946
"S01004066",709,814,105,0.128992628992629,0.251314937647703
"S01004067",732,851,119,0.139835487661575,0.221725278841313
"S01004068",752,873,121,0.138602520045819,0.224924088331638
"S01004069",686,870,184,0.211494252873563,0.0929070415234014
"S01004070",650,855,205,0.239766081871345,0.0644870364616851
"S01004071",802,906,104,0.114790286975717,0.295434837725426
"S01004072",959,1186,227,0.191399662731872,0.119492096635119
"S01004073",775,889,114,0.128233970753656,0.25351252177579
"S01004074",824,991,167,0.168516649848638,0.157955798060602
"S01004075",579,687,108,0.157205240174672,0.180808259951792
"S01004076",584,693,109,0.157287157287157,0.180632596614816
"S01004077",868,1026,158,0.153996101364522,0.187812132554399
"S01004078",652,780,128,0.164102564102564,0.166544360174969
"S01004079",766,912,146,0.160087719298246,0.174718669178238
"S01004080",705,806,101,0.12531017369727,0.26214450094237
"S01004081",747,995,248,0.249246231155779,0.056882046194092
"S01004082",633,777,144,0.185328185328185,0.128773622281733
"S01004083",845,947,102,0.107708553326294,0.319939085766243
"S01004084",696,804,108,0.134328358208955,0.236337103511709
"S01004085",464,629,165,0.262321144674086,0.0477170241309374
"S01004086",692,818,126,0.154034229828851,0.187727504858684
"S01004087",562,665,103,0.154887218045113,0.185843211881585
"S01004088",532,594,62,0.104377104377104,0.33208699866883
"S01004089",757,865,108,0.12485549132948,0.263510375795143
"S01004090",641,814,173,0.212530712530713,0.0916930135423794
"S01004091",673,793,120,0.151324085750315,0.193829006205658
"S01004092",606,788,182,0.230964467005076,0.0723542534381989
"S01004093",482,633,151,0.238546603475513,0.065528961029757
"S01004094",429,622,193,0.310289389067524,0.0243595395523337
"S01004095",455,592,137,0.231418918918919,0.071927820249931
"S01004096",716,789,73,0.0925221799746515,0.378756583984476
"S01004097",796,962,166,0.172557172557173,0.150445761536093
"S01004098",594,665,71,0.106766917293233,0.323331484913318
"S01004099",707,834,127,0.152278177458034,0.191660947846291
"S01004100",735,851,116,0.136310223266745,0.230981815207307
"S01004101",668,837,169,0.201911589008363,0.104835904085909
"S01004102",749,834,85,0.101918465227818,0.34131680420115
"S01004103",743,844,101,0.119668246445498,0.279552687250889
"S01004104",759,841,82,0.0975029726516052,0.358474114785743
"S01004105",755,856,101,0.117990654205607,0.284925861133879
"S01004106",719,900,181,0.201111111111111,0.105892160549412
"S01004107",659,716,57,0.079608938547486,0.436238431189094
"S01004108",706,825,119,0.144242424242424,0.210623839345947
"S01004109",581,650,69,0.106153846153846,0.325557539474214
"S01004110",517,614,97,0.157980456026059,0.179152024199346
"S01004111",762,952,190,0.199579831932773,0.107939457143521
"S01004112",751,927,176,0.189859762675297,0.121787307358326
"S01004113",680,771,91,0.118028534370947,0.284803516023676
"S01004114",564,691,127,0.183791606367583,0.13122318243449
"S01004115",698,814,116,0.142506142506143,0.214936502345831
"S01004116",610,729,119,0.16323731138546,0.168276343626104
"S01004117",656,810,154,0.190123456790123,0.121391479613333
"S01004118",790,975,185,0.18974358974359,0.121962061323662
"S01004119",511,666,155,0.232732732732733,0.0707076998410515
"S01004120",659,791,132,0.166877370417193,0.161097689221974
"S01004121",519,632,113,0.17879746835443,0.139477063609379
"S01004122",575,673,98,0.145616641901932,0.207265875231151
"S01004123",481,555,74,0.133333333333333,0.2390677160551
"S01004124",875,1036,161,0.155405405405405,0.184706839042845
"S01004125",594,673,79,0.117384843982169,0.286888941128761
"S01004126",636,759,123,0.162055335968379,0.170668510227457
"S01004127",946,986,40,0.0405679513184584,0.660909834924859
"S01004128",716,787,71,0.0902160101651842,0.388492733022731
"S01004129",786,904,118,0.130530973451327,0.246911407784557
"S01004130",545,608,63,0.103618421052632,0.334910859694624
"S01004131",729,862,133,0.154292343387471,0.187155513161128
"S01004132",564,602,38,0.0631229235880399,0.520986089027837
"S01004133",853,952,99,0.103991596638655,0.333519190352078
"S01004134",666,753,87,0.115537848605578,0.292949343908829
"S01004135",602,705,103,0.146099290780142,0.206097983538027
"S01004136",599,686,87,0.126822157434402,0.257648172779357
"S01004137",480,612,132,0.215686274509804,0.0880842279823248
"S01004138",652,763,111,0.145478374836173,0.207601543327463
"S01004139",560,673,113,0.167904903417533,0.159121779811881
"S01004140",562,648,86,0.132716049382716,0.240775945513092
"S01004141",692,737,45,0.0610583446404342,0.532581487084846
"S01004142",542,617,75,0.121555915721232,0.273615833300603
"S01004143",831,955,124,0.129842931937173,0.248872277408243
"S01004144",775,923,148,0.160346695557963,0.174180693276534
"S01004145",643,743,100,0.134589502018843,0.235625121577457
"S01004146",647,781,134,0.17157490396927,0.1522412944423
"S01004147",802,891,89,0.0998877665544332,0.349113499548928
"S01004148",920,1059,139,0.131255901794145,0.244860466398304
"S01004149",591,677,86,0.127031019202363,0.257032548290362
"S01004150",548,614,66,0.107491856677524,0.320716920671933
"S01004151",536,731,195,0.266757865937073,0.0449235561122633
"S01004152",713,786,73,0.0928753180661578,0.377285259879758
"S01004153",734,877,143,0.163055872291904,0.1686415811849
"S01004154",627,717,90,0.125523012552301,0.261507321006836
"S01004155",862,1001,139,0.138861138861139,0.224249706575336
"S01004156",738,855,117,0.136842105263158,0.229563306233955
"S01004157",609,695,86,0.123741007194245,0.266885439406848
"S01004158",587,672,85,0.126488095238095,0.258635587280879
"S01004159",578,634,56,0.0883280757097792,0.396630224152945
"S01004160",582,685,103,0.15036496350365,0.196030718437923
"S01004161",544,693,149,0.215007215007215,0.088849840162714
"S01004162",599,760,161,0.211842105263158,0.0924979911821528
"S01004163",679,790,111,0.140506329113924,0.220002101803374
"S01004164",898,996,98,0.0983935742971888,0.354952290028632
"S01004165",952,1070,118,0.110280373831776,0.310836282996021
"S01004166",493,554,61,0.110108303249097,0.311437959649256
"S01004167",634,712,78,0.109550561797753,0.313395417910103
"S01004168",655,753,98,0.130146082337317,0.248006599658155
"S01004169",550,635,85,0.133858267716535,0.237623638771889
"S01004170",560,633,73,0.115323854660348,0.293658901507368
"S01004171",588,660,72,0.109090909090909,0.315016937670845
"S01004172",690,787,97,0.123252858958069,0.268375943211556
"S01004173",550,625,75,0.12,0.278500976009402
"S01004174",732,799,67,0.0838548185231539,0.416526864835489
"S01004175",590,688,98,0.142441860465116,0.21509768389583
"S01004176",590,698,108,0.154727793696275,0.186194089270356
"S01004177",476,544,68,0.125,0.263075576163828
"S01004178",543,595,52,0.0873949579831933,0.400708577164692
"S01004179",497,545,48,0.0880733944954128,0.397739629240718
"S01004180",750,955,205,0.214659685863874,0.0892439775077691
"S01004181",721,775,54,0.0696774193548387,0.485663675343692
"S01004182",807,1002,195,0.194610778443114,0.114830731635409
"S01004183",885,1175,290,0.246808510638298,0.0587562460594602
"S01004184",816,923,107,0.115926327193933,0.291665175059492
"S01004185",795,906,111,0.122516556291391,0.270638333031399
"S01004186",681,771,90,0.116731517509728,0.289019628601961
"S01004187",696,756,60,0.0793650793650794,0.437395631396735
"S01004188",728,824,96,0.116504854368932,0.289762163854388
"S01004189",431,674,243,0.36053412462908,0.0114333562616802
"S01004190",742,865,123,0.142196531791908,0.215713824212075
"S01004191",716,815,99,0.121472392638037,0.273876100504356
"S01004192",809,923,114,0.123510292524377,0.267588968761097
"S01004193",723,814,91,0.111793611793612,0.305589849130406
"S01004194",723,827,104,0.125755743651753,0.260812184933761
"S01004195",576,645,69,0.106976744186047,0.322572758319734
"S01004196",659,728,69,0.0947802197802198,0.369436969287069
"S01004197",657,740,83,0.112162162162162,0.304324206488944
"S01004198",632,771,139,0.180285343709468,0.13697048776072
"S01004199",779,878,99,0.112756264236902,0.302293923695953
"S01004200",767,845,78,0.0923076923076923,0.379652749975774
"S01004201",711,796,85,0.10678391959799,0.323269945437305
"S01004202",527,607,80,0.131795716639209,0.243343214893405
"S01004203",831,911,80,0.0878155872667399,0.398865495057071
"S01004204",695,788,93,0.118020304568528,0.284830092564739
"S01004205",681,766,85,0.110966057441253,0.308449039924867
"S01004206",674,761,87,0.114323258869908,0.296997229206563
"S01004207",752,841,89,0.105826397146254,0.326752145528161
"S01004208",820,903,83,0.0919158361018826,0.38129492132058
"S01004209",542,635,93,0.146456692913386,0.205236978556524
"S01004210",642,742,100,0.134770889487871,0.235131723868599
"S01004211",660,778,118,0.151670951156812,0.193038256101149
"S01004212",740,875,135,0.154285714285714,0.187170183912835
"S01004213",554,649,95,0.146379044684129,0.205423762440705
"S01004214",664,759,95,0.125164690382082,0.262580840857135
"S01004215",512,673,161,0.239227340267459,0.0649454854702804
"S01004216",834,937,103,0.109925293489861,0.312079037230622
"S01004217",521,633,112,0.17693522906793,0.142672454508278
"S01004218",824,907,83,0.0915104740904079,0.383000416606501
"S01004219",637,711,74,0.10407876230661,0.33319487754875
"S01004220",713,829,116,0.139927623642943,0.221487893647417
"S01004221",877,943,66,0.0699893955461294,0.484037496764348
"S01004222",472,637,165,0.259026687598116,0.049891396802012
"S01004223",765,861,96,0.111498257839721,0.306607544455678
"S01004224",702,799,97,0.121401752190238,0.274096397875137
"S01004225",751,873,122,0.139747995418099,0.221950911538851
"S01004226",676,807,131,0.162329615861214,0.170110692364555
"S01004227",571,635,64,0.100787401574803,0.345639867150569
"S01004228",694,828,134,0.161835748792271,0.171116282530838
"S01004229",674,749,75,0.100133511348465,0.348161534938287
"S01004230",675,767,92,0.119947848761408,0.278666067427605
"S01004231",734,801,67,0.083645443196005,0.417479772678799
"S01004232",617,748,131,0.175133689839572,0.145826234508861
"S01004233",591,676,85,0.125739644970414,0.260860215906435
"S01004234",875,1070,195,0.182242990654206,0.133734282920815
"S01004235",564,690,126,0.182608695652174,0.133137418690343
"S01004236",819,935,116,0.124064171122995,0.265902798978373
"S01004237",618,710,92,0.129577464788732,0.249632579096868
"S01004238",525,615,90,0.146341463414634,0.205514219632257
"S01004239",607,709,102,0.143864598025388,0.211555616111386
"S01004240",575,690,115,0.166666666666667,0.161505582889846
"S01004241",500,539,39,0.0723562152133581,0.471859161361851
"S01004242",782,929,147,0.158234660925727,0.178611900131243
"S01004243",540,622,82,0.131832797427653,0.243239303585815
"S01004244",566,655,89,0.13587786259542,0.232140711909698
"S01004245",825,969,144,0.148606811145511,0.200125170527467
"S01004246",524,620,96,0.154838709677419,0.18594991100995
"S01004247",795,906,111,0.122516556291391,0.270638333031399
"S01004248",862,984,122,0.123983739837398,0.26614706051664
"S01004249",827,956,129,0.134937238493724,0.234680050373452
"S01004250",943,1082,139,0.128465804066543,0.25283914885308
"S01004251",843,967,124,0.1282316442606,0.253519287377852
"S01004252",505,573,68,0.118673647469459,0.282727180053085
"S01004253",543,593,50,0.0843170320404722,0.414430168340206
"S01004254",634,781,147,0.188220230473752,0.124274561679965
"S01004255",628,771,143,0.185473411154345,0.128544250642271
"S01004256",482,729,247,0.338820301783265,0.0159659622911937
"S01004257",481,597,116,0.194304857621441,0.115267653530221
"S01004258",638,760,122,0.160526315789474,0.173808441113944
"S01004259",544,700,156,0.222857142857143,0.0803542028105559
"S01004260",508,617,109,0.176661264181524,0.143148065221861
"S01004261",764,936,172,0.183760683760684,0.131272905700974
"S01004262",688,811,123,0.151664611590629,0.193052682342439
"S01004263",700,804,104,0.129353233830846,0.25027640763089
"S01004264",660,737,77,0.104477611940299,0.331714515954253
"S01004265",827,1045,218,0.208612440191388,0.0963589793104933
"S01004266",497,573,76,0.132635253054101,0.241000346874049
"S01004267",485,543,58,0.106813996316759,0.323161109218261
"S01004268",507,717,210,0.292887029288703,0.0312527355170767
"S01004269",682,837,155,0.185185185185185,0.128999838512784
"S01004270",470,609,139,0.22824302134647,0.0749558706418555
"S01004271",539,625,86,0.1376,0.227555574188924
"S01004272",583,700,117,0.167142857142857,0.160585063375415
"S01004273",648,763,115,0.150720838794233,0.195211176628954
"S01004274",724,881,157,0.178206583427923,0.140483907307559
"S01004275",552,632,80,0.126582278481013,0.25835685813421
"S01004276",623,785,162,0.206369426751592,0.0991251594999427
"S01004277",750,862,112,0.129930394431555,0.24862224039582
"S01004278",847,989,142,0.143579373104146,0.212261479657282
"S01004279",827,1049,222,0.21163012392755,0.0927470732057112
"S01004280",940,1029,89,0.086491739552964,0.404692157556696
"S01004281",528,622,94,0.15112540192926,0.194283258331282
"S01004282",896,1076,180,0.16728624535316,0.160308807428298
"S01004283",671,819,148,0.180708180708181,0.13626558470639
"S01004284",902,1029,127,0.123420796890185,0.267862321099699
"S01004285",631,1212,581,0.479372937293729,0.001463077710865
"S01004286",565,938,373,0.397654584221748,0.00628718289767281
"S01004287",590,704,114,0.161931818181818,0.170920252213762
"S01004288",678,827,149,0.180169286577993,0.137164537403899
"S01004289",568,657,89,0.135464231354642,0.23325430154755
"S01004290",647,747,100,0.133868808567604,0.237594721816083
"S01004291",750,910,160,0.175824175824176,0.144610128059448
"S01004292",548,921,373,0.40499457111835,0.00556172207434604
"S01004293",695,876,181,0.20662100456621,0.0988113844424655
"S01004294",640,857,217,0.253208868144691,0.0539500088929769
"S01004295",734,916,182,0.198689956331878,0.1091455069753
"S01004296",819,1021,202,0.197845249755142,0.110301545270446
"S01004297",642,895,253,0.28268156424581,0.0360678228162242
"S01004298",874,1084,210,0.193726937269373,0.116097135481199
"S01004299",446,646,200,0.309597523219814,0.0246050021415902
"S01004300",498,597,99,0.165829145728643,0.163136115263618
"S01004301",587,669,82,0.122571001494768,0.270470456979711
"S01004302",701,826,125,0.151331719128329,0.193811573046953
"S01004303",563,654,91,0.13914373088685,0.223514892693049
"S01004304",813,1063,250,0.235183443085607,0.0684814284534124
"S01004305",591,724,133,0.183701657458564,0.131367866529709
"S01004306",524,621,97,0.156199677938808,0.182977153879191
"S01004307",786,1360,574,0.422058823529412,0.00415753942945249
"S01004308",916,1052,136,0.129277566539924,0.250494006163313
"S01004309",642,941,299,0.317747077577046,0.0218501310673199
"S01004310",688,868,180,0.207373271889401,0.0978784606668129
"S01004311",689,857,168,0.196032672112019,0.112819455625532
"S01004312",627,754,127,0.168435013262599,0.158110950545905
"S01004313",890,1053,163,0.154795821462488,0.186044293954766
"S01004314",740,821,81,0.0986601705237515,0.353904126175506
"S01004315",453,603,150,0.248756218905473,0.0572544040744718
"S01004316",337,660,323,0.489393939393939,0.00120464658359407
"S01004317",809,955,146,0.152879581151832,0.190305570249612
"S01004318",584,644,60,0.093167701863354,0.376070958959315
"S01004319",806,921,115,0.12486427795874,0.263483920011579
"S01004320",844,992,148,0.149193548387097,0.198750277963704
"S01004321",739,869,130,0.149597238204833,0.197809260544529
"S01004322",931,1062,131,0.123352165725047,0.268072115964875
"S01004323",591,697,106,0.152080344332855,0.192108697651828
"S01004324",795,889,94,0.105736782902137,0.327079764859863
"S01004325",889,1098,209,0.190346083788707,0.121058198999283
"S01004326",755,853,98,0.114888628370457,0.295106791688591
"S01004327",656,761,105,0.137976346911958,0.22656448124271
"S01004328",636,709,73,0.10296191819464,0.337371820499838
"S01004329",502,569,67,0.117750439367311,0.285702807130397
"S01004330",892,1087,195,0.179392824287029,0.138469174430961
"S01004331",523,594,71,0.11952861952862,0.279996394417202
"S01004332",547,614,67,0.109120521172638,0.314912247840234
"S01004333",479,572,93,0.162587412587413,0.169587893694766
"S01004334",1247,2063,816,0.395540475036355,0.00651136821276941
"S01004335",495,568,73,0.128521126760563,0.25267869906193
"S01004336",900,1080,180,0.166666666666667,0.161505582889846
"S01004337",630,771,141,0.182879377431907,0.132697186241312
"S01004338",635,774,139,0.179586563307494,0.138142606498591
"S01004339",840,982,142,0.144602851323829,0.209738415505191
"S01004340",517,624,107,0.171474358974359,0.152426168887525
"S01004341",531,681,150,0.220264317180617,0.083075715749515
"S01004342",616,881,265,0.300794551645857,0.0279285274295278
"S01004343",414,582,168,0.288659793814433,0.0331721457359275
"S01004344",659,844,185,0.219194312796209,0.0842228008091037
"S01004345",835,1027,192,0.186952288218111,0.126229342146538
"S01004346",524,586,62,0.10580204778157,0.326841134759703
"S01004347",712,864,152,0.175925925925926,0.144431696188408
"S01004348",524,623,99,0.158908507223114,0.177187223657874
"S01004349",733,841,108,0.128418549346017,0.252976272088833
"S01004350",514,609,95,0.155993431855501,0.183424888447325
"S01004351",471,542,71,0.1309963099631,0.245593125378134
"S01004352",570,673,103,0.153046062407132,0.189931900752347
"S01004353",844,968,124,0.128099173553719,0.253904789479014
"S01004354",472,673,201,0.298662704309064,0.0287918349536062
"S01004355",527,600,73,0.121666666666667,0.273271064336656
"S01004356",939,1060,121,0.114150943396226,0.297575567163521
"S01004357",731,825,94,0.113939393939394,0.298286971021526
"S01004358",743,815,72,0.0883435582822086,0.396562871120173
"S01004359",490,539,49,0.0909090909090909,0.385543289429532
"S01004360",637,747,110,0.147255689424364,0.203323840913104
"S01004361",528,617,89,0.144246353322528,0.210614169074107
"S01004362",502,585,83,0.141880341880342,0.216510274497738
"S01004363",882,1081,199,0.1840888066605,0.130746150739128
"S01004364",690,871,181,0.207807118254879,0.0973440379382089
"S01004365",692,851,159,0.186839012925969,0.126405317470685
"S01004366",588,645,57,0.0883720930232558,0.396438764882073
"S01004367",810,962,152,0.158004158004158,0.179101601147411
"S01004368",490,587,97,0.165247018739353,0.164278144083392
"S01004369",729,828,99,0.119565217391304,0.27988003228092
"S01004370",692,757,65,0.0858652575957728,0.407476108202564
"S01004371",709,816,107,0.131127450980392,0.24522275331082
"S01004372",922,1043,121,0.11601150527325,0.291384285448813
"S01004373",525,614,89,0.144951140065147,0.208885994740677
"S01004374",499,644,145,0.225155279503106,0.0780093721666232
"S01004375",695,825,130,0.157575757575758,0.180014944291079
"S01004376",862,1003,141,0.140578265204387,0.219818038413978
"S01004377",644,807,163,0.201982651796778,0.104742594282183
"S01004378",906,1016,110,0.108267716535433,0.317939800427513
"S01004379",891,1012,121,0.119565217391304,0.27988003228092
"S01004380",660,767,107,0.139504563233377,0.222579783645447
"S01004381",757,878,121,0.137813211845103,0.226993612201839
"S01004382",641,732,91,0.12431693989071,0.265136479018538
"S01004383",763,871,108,0.123995407577497,0.266111614272582
"S01004384",612,738,126,0.170731707317073,0.153797970011677
"S01004385",777,912,135,0.148026315789474,0.201493854450223
"S01004386",833,975,142,0.145641025641026,0.207206730024714
"S01004387",913,1028,115,0.111867704280156,0.305335027563908
"S01004388",881,1071,190,0.177404295051354,0.14186144387155
"S01004389",605,721,116,0.160887656033287,0.173061753325164
"S01004390",772,890,118,0.132584269662921,0.241142043496267
"S01004391",560,650,90,0.138461538461538,0.225292484103636
"S01004392",824,964,140,0.145228215767635,0.208210092904217
"S01004393",863,961,98,0.101977107180021,0.341094000338746
"S01004394",739,842,103,0.122327790973872,0.271221097461699
"S01004395",486,574,88,0.153310104529617,0.189340608556905
"S01004396",752,851,99,0.116333725029377,0.290323910590861
"S01004397",874,1066,192,0.180112570356473,0.137259457933755
"S01004398",804,915,111,0.121311475409836,0.274378164710851
"S01004399",465,555,90,0.162162162162162,0.170451056590003
"S01004400",539,589,50,0.0848896434634974,0.411845859350511
"S01004401",1045,1158,113,0.0975820379965458,0.358160189004354
"S01004402",887,1035,148,0.142995169082126,0.213713865895237
"S01004403",472,565,93,0.164601769911504,0.16555241032291
"S01004404",631,720,89,0.123611111111111,0.267281332726821
"S01004405",659,804,145,0.180348258706468,0.136865396043604
"S01004406",791,968,177,0.182851239669421,0.132742887946101
"S01004407",593,712,119,0.167134831460674,0.160600538545215
"S01004408",538,602,64,0.106312292358804,0.324980905245121
"S01004409",558,721,163,0.226074895977809,0.0770884550913762
"S01004410",900,1117,217,0.194270367054611,0.115317007342185
"S01004411",579,693,114,0.164502164502165,0.165749906143606
"S01004412",868,1066,198,0.185741088180113,0.128122441168795
"S01004413",719,871,152,0.17451205510907,0.146928942810088
"S01004414",597,814,217,0.266584766584767,0.0450297216510348
"S01004415",590,675,85,0.125925925925926,0.260304926810834
"S01004416",602,740,138,0.186486486486486,0.12695438771379
"S01004417",683,832,149,0.179086538461538,0.138986869755464
"S01004418",865,1001,136,0.135864135864136,0.232177590503915
"S01004419",800,874,74,0.0846681922196796,0.412843587763761
"S01004420",705,805,100,0.124223602484472,0.265419218580806
"S01004421",614,856,242,0.282710280373832,0.0360533865268066
"S01004422",513,590,77,0.130508474576271,0.246975307425198
"S01004423",749,915,166,0.181420765027322,0.135085033969104
"S01004424",653,788,135,0.171319796954315,0.152710759765074
"S01004425",601,668,67,0.100299401197605,0.34752023341614
"S01004426",525,589,64,0.108658743633277,0.316548373377934
"S01004427",668,810,142,0.175308641975309,0.145517235651776
"S01004428",677,800,123,0.15375,0.188359191193363
"S01004429",794,927,133,0.143473570658037,0.21252385391772
"S01004430",483,542,59,0.108856088560886,0.315848226117691
"S01004431",615,803,188,0.23412204234122,0.0694377604036016
"S01004432",872,1005,133,0.132338308457711,0.241826690138137
"S01004433",915,1026,111,0.108187134502924,0.318227225887824
"S01004434",734,846,112,0.132387706855792,0.24168904673185
"S01004435",531,658,127,0.193009118541033,0.117134890170247
"S01004436",758,844,86,0.101895734597156,0.341403202034957
"S01004437",869,994,125,0.125754527162978,0.260815814092086
"S01004438",651,761,110,0.144546649145861,0.209876260734091
"S01004439",648,748,100,0.133689839572193,0.238086121381044
"S01004440",661,770,109,0.141558441558442,0.217323826460464
"S01004441",733,896,163,0.181919642857143,0.134264021091999
"S01004442",855,1009,154,0.152626362735382,0.190875191118433
"S01004443",654,751,97,0.129161118508655,0.250829211663292
"S01004444",843,947,104,0.109820485744456,0.312446710157788
"S01004445",646,814,168,0.206388206388206,0.0991017060654643
"S01004446",750,851,101,0.118683901292597,0.282694287779788
"S01004447",721,809,88,0.108776266996292,0.31613125183093
"S01004448",568,681,113,0.165932452276065,0.16293419452125
"S01004449",835,1013,178,0.175715695952616,0.144800579932726
"S01004450",813,988,175,0.177125506072875,0.142342965700515
"S01004451",843,981,138,0.140672782874618,0.219576406062649
"S01004452",638,757,119,0.157199471598415,0.180820635899189
"S01004453",944,1148,204,0.177700348432056,0.141351708578794
"S01004454",880,977,97,0.0992835209825998,0.351464191716247
"S01004455",721,851,130,0.152761457109283,0.190571102442559
"S01004456",510,633,123,0.194312796208531,0.115256296607654
"S01004457",831,920,89,0.0967391304347826,0.361519697047355
"S01004458",788,900,112,0.124444444444444,0.264750677717529
"S01004459",514,586,72,0.122866894197952,0.269559740598667
"S01004460",625,688,63,0.0915697674418605,0.382750521487632
"S01004461",572,630,58,0.0920634920634921,0.38067538303444
"S01004462",536,703,167,0.237553342816501,0.066388773711839
"S01004463",744,853,109,0.12778429073857,0.254823246132657
"S01004464",767,947,180,0.190073917634636,0.121465753735889
"S01004465",703,835,132,0.158083832335329,0.178932197394932
"S01004466",857,970,113,0.116494845360825,0.289794992327976
"S01004467",918,1101,183,0.166212534059946,0.162387883825783
"S01004468",663,812,149,0.183497536945813,0.131696729992121
"S01004469",641,744,103,0.138440860215054,0.225346563601238
"S01004470",514,614,100,0.162866449511401,0.16902365103133
"S01004471",545,688,143,0.207848837209302,0.0972927861622081
"S01004472",688,772,84,0.10880829015544,0.31601767895048
"S01004473",933,1076,143,0.132899628252788,0.240266777816998
"S01004474",950,1074,124,0.115456238361266,0.293219763585543
"S01004475",469,575,106,0.184347826086957,0.130331676045297
"S01004476",647,815,168,0.206134969325153,0.099418388505928
"S01004477",811,995,184,0.184924623115578,0.129412949250852
"S01004478",590,710,120,0.169014084507042,0.157013367906704
"S01004479",600,721,121,0.167822468793343,0.159279490071976
"S01004480",923,1022,99,0.0968688845401174,0.361000706853594
"S01004481",535,610,75,0.122950819672131,0.26930193262521
"S01004482",862,978,116,0.118609406952965,0.282933329553126
"S01004483",648,778,130,0.167095115681234,0.160677138512298
"S01004484",893,1076,183,0.170074349442379,0.155021478847699
"S01004485",474,572,98,0.171328671328671,0.152694406687751
"S01004486",881,1015,134,0.132019704433498,0.242716142720729
"S01004487",973,1123,150,0.133570792520036,0.238413498176866
"S01004488",660,766,106,0.138381201044386,0.225502654790642
"S01004489",789,902,113,0.125277161862528,0.262243454200596
"S01004490",654,754,100,0.13262599469496,0.241026072786373
"S01004491",775,865,90,0.104046242774566,0.333315838086737
"S01004492",930,1059,129,0.121813031161473,0.27281602978204
"S01004493",980,1114,134,0.120287253141831,0.27759321612834
"S01004494",827,965,138,0.14300518134715,0.213688899322147
"S01004495",644,705,61,0.0865248226950355,0.404545620223467
"S01004496",591,688,97,0.140988372093023,0.218771339769055
"S01004497",779,900,121,0.134444444444444,0.236020367542174
"S01004498",560,647,87,0.134466769706337,0.235959497908378
"S01004499",638,734,96,0.130790190735695,0.24617627054963
"S01004500",702,794,92,0.115869017632242,0.291854300476191
"S01004501",478,609,131,0.215106732348112,0.0887372651505026
"S01004502",723,801,78,0.0973782771535581,0.358969716539204
"S01004503",652,785,133,0.169426751592357,0.156235380653975
"S01004504",672,741,69,0.0931174089068826,0.376279580127825
"S01004505",579,636,57,0.089622641509434,0.39103396425334
"S01004506",506,588,82,0.139455782312925,0.22270599485451
"S01004507",711,794,83,0.104534005037783,0.331505686903854
"S01004508",655,781,126,0.161331626120359,0.172148269411133
"S01004509",654,750,96,0.128,0.254193739002788
"S01004510",736,893,157,0.175811870100784,0.144631721168025
"S01004511",761,946,185,0.195560253699789,0.113484148580027
"S01004512",880,1013,133,0.131293188548865,0.244755391854704
"S01004513",451,547,96,0.175502742230347,0.145175107216277
"S01004514",532,606,74,0.122112211221122,0.271888025805893
"S01004515",770,1072,302,0.281716417910448,0.0365560614047003
"S01004516",459,554,95,0.171480144404332,0.152415525605374
"S01004517",667,855,188,0.219883040935673,0.0834828355767339
"S01004518",622,743,121,0.162853297442799,0.169050207938803
"S01004519",817,971,154,0.15859938208033,0.177839515388968
"S01004520",727,926,199,0.214902807775378,0.0889680848167042
"S01004521",737,851,114,0.133960047003525,0.237344557661178
"S01004522",568,637,69,0.108320251177394,0.317752542138048
"S01004523",769,921,152,0.165038002171553,0.164689949374202
"S01004524",575,666,91,0.136636636636637,0.230110351168669
"S01004525",664,808,144,0.178217821782178,0.140464696752565
"S01004526",641,775,134,0.172903225806452,0.149817749890637
"S01004527",529,601,72,0.119800332778702,0.279133525180657
"S01004528",756,833,77,0.092436974789916,0.379112357567443
"S01004529",831,936,105,0.112179487179487,0.304264826735471
"S01004530",572,628,56,0.089171974522293,0.392974029936055
"S01004531",688,792,104,0.131313131313131,0.244699209552419
"S01004532",567,757,190,0.250990752972259,0.0555740175557739
"S01004533",499,727,228,0.313617606602476,0.0232092628824321
"S01004534",650,745,95,0.12751677852349,0.255605879271461
"S01004535",683,767,84,0.109517601043025,0.313511443254944
"S01004536",712,775,63,0.0812903225806452,0.428334357439814
"S01004537",810,895,85,0.0949720670391061,0.368654751362419
"S01004538",742,849,107,0.12603062426384,0.259993296383426
"S01004539",714,825,111,0.134545454545455,0.235745077006178
"S01004540",662,925,263,0.284324324324324,0.035250279673541
"S01004541",710,831,121,0.14560770156438,0.207287564723676
"S01004542",490,604,114,0.188741721854305,0.123478519612927
"S01004543",720,797,77,0.0966122961104141,0.36202765762309
"S01004544",924,1078,154,0.142857142857143,0.214058315601308
"S01004545",675,807,132,0.163568773234201,0.167610947480014
"S01004546",897,1038,141,0.135838150289017,0.232247418466834
"S01004547",799,896,97,0.108258928571429,0.31797113457886
"S01004548",704,851,147,0.172737955346651,0.150117385016743
"S01004549",796,892,96,0.10762331838565,0.320244834681058
"S01004550",630,736,106,0.144021739130435,0.211167632641517
"S01004551",903,992,89,0.0897177419354839,0.390625671802374
"S01004552",679,796,117,0.146984924623116,0.203970361418596
"S01004553",485,565,80,0.141592920353982,0.217236555410327
"S01004554",587,708,121,0.17090395480226,0.153478814363468
"S01004555",653,799,146,0.182728410513141,0.13294255452916
"S01004556",604,723,119,0.164591977869986,0.165571816416034
"S01004557",467,546,79,0.144688644688645,0.209528150072206
"S01004558",899,1042,143,0.137236084452975,0.228517638648531
"S01004559",936,1064,128,0.120300751879699,0.277550623823744
"S01004560",585,702,117,0.166666666666667,0.161505582889846
"S01004561",1012,1103,91,0.0825022665457842,0.422717279208363
"S01004562",491,573,82,0.143106457242583,0.213436505386735
"S01004563",743,829,86,0.103739445114596,0.334458957775367
"S01004564",553,604,51,0.0844370860927152,0.413887134574841
"S01004565",596,743,147,0.197846567967699,0.110299732655028
"S01004566",668,778,110,0.141388174807198,0.217755260213717
"S01004567",464,538,74,0.137546468401487,0.227696863808662
"S01004568",637,704,67,0.0951704545454545,0.367847434897119
"S01004569",600,765,165,0.215686274509804,0.0880842279823248
"S01004570",658,753,95,0.126162018592297,0.259602681527761
"S01004571",616,733,117,0.159618008185539,0.175698225484251
"S01004572",684,794,110,0.138539042821159,0.225089892071743
"S01004573",578,640,62,0.096875,0.360976262805186
"S01004574",491,533,42,0.0787992495309568,0.440091348358
"S01004575",664,781,117,0.149807938540333,0.197319703819761
"S01004576",566,671,105,0.156482861400894,0.182364000284065
"S01004577",536,626,90,0.143769968051118,0.211789568158441
"S01004578",901,983,82,0.0834181078331638,0.418516641424378
"S01004579",606,708,102,0.144067796610169,0.211054037532666
"S01004580",838,934,96,0.102783725910064,0.338042592722068
"S01004581",1019,1167,148,0.126820908311911,0.257651858582909
"S01004582",557,610,53,0.0868852459016393,0.402952265315065
"S01004583",903,1085,182,0.167741935483871,0.159433698657419
"S01004584",693,774,81,0.104651162790698,0.331072218707179
"S01004585",593,631,38,0.0602218700475436,0.537345159712764
"S01004586",1027,1170,143,0.122222222222222,0.271547506060638
"S01004587",850,958,108,0.112734864300626,0.302366843600917
"S01004588",650,730,80,0.10958904109589,0.313260015601627
"S01004589",708,809,101,0.124845488257108,0.263540497094179
"S01004590",717,944,227,0.240466101694915,0.0638956972556065
"S01004591",583,635,52,0.0818897637795276,0.425547746138768
"S01004592",630,700,70,0.1,0.3486784401
"S01004593",749,891,142,0.159371492704826,0.1762142949712
"S01004594",596,700,104,0.148571428571429,0.200208354984893
"S01004595",897,978,81,0.0828220858895705,0.421246089788341
"S01004596",650,766,116,0.151436031331593,0.193573485513891
"S01004597",534,596,62,0.104026845637584,0.333388007022182
"S01004598",648,728,80,0.10989010989011,0.312202420326361
"S01004599",515,618,103,0.166666666666667,0.161505582889846
"S01004600",832,935,103,0.110160427807487,0.3112555859071
"S01004601",790,905,115,0.12707182320442,0.256912432328337
"S01004602",941,1022,81,0.0792563600782779,0.437912433642909
"S01004603",818,1034,216,0.20889748549323,0.0960124714843938
"S01004604",526,587,61,0.103918228279387,0.333792388395494
"S01004605",973,1088,115,0.105698529411765,0.327219705216921
"S01004606",685,803,118,0.146948941469489,0.204056419572126
"S01004607",591,655,64,0.0977099236641221,0.357652947812163
"S01004608",541,659,118,0.179059180576631,0.139033195674703
"S01004609",556,635,79,0.124409448818898,0.264856516600668
"S01004610",718,784,66,0.0841836734693878,0.415034133381428
"S01004611",1218,1289,71,0.0550814584949573,0.567471048553066
"S01004612",651,809,158,0.195302843016069,0.113847807039365
"S01004613",789,942,153,0.162420382165605,0.169926457698442
"S01004614",786,879,93,0.10580204778157,0.326841134759703
"S01004615",893,1008,115,0.114087301587302,0.297789422684467
"S01004616",825,943,118,0.125132555673383,0.262677308770922
"S01004617",686,847,161,0.190082644628099,0.121452666375635
"S01004618",605,716,111,0.155027932960894,0.185534006683337
"S01004619",734,937,203,0.216648879402348,0.0870091027718747
"S01004620",685,920,235,0.255434782608696,0.0523633522014057
"S01004621",949,1049,100,0.0953288846520496,0.367203863835367
"S01004622",586,845,259,0.306508875739645,0.0257281803071889
"S01004623",919,1052,133,0.126425855513308,0.258819930162332
"S01004624",974,1127,153,0.135758651286602,0.232461164114746
"S01004625",833,920,87,0.0945652173913043,0.370315372323809
"S01004626",595,702,107,0.152421652421652,0.191336813054165
"S01004627",521,637,116,0.182103610675039,0.133962396950064
"S01004628",544,637,93,0.145996860282575,0.206345343892995
"S01004629",910,1080,170,0.157407407407407,0.180375010067524
"S01004630",904,1001,97,0.0969030969030969,0.360863976075374
"S01004631",765,840,75,0.0892857142857143,0.39248357879171
"S01004632",907,1057,150,0.141911069063387,0.216432759912329
"S01004633",577,622,45,0.0723472668810289,0.471904680298621
"S01004634",1012,1132,120,0.106007067137809,0.326092534687834
"S01004635",697,790,93,0.117721518987342,0.285796475101989
"S01004636",630,714,84,0.117647058823529,0.286037765539156
"S01004637",522,572,50,0.0874125874125874,0.400631176217061
"S01004638",550,661,111,0.167927382753404,0.159078797740096
"S01004639",672,747,75,0.100401606425703,0.347125655115224
"S01004640",752,864,112,0.12962962962963,0.249483013432747
"S01004641",619,694,75,0.10806916426513,0.318648431927129
"S01004642",875,969,94,0.0970072239422085,0.360448115860696
"S01004643",513,597,84,0.14070351758794,0.219497884962755
"S01004644",699,775,76,0.0980645161290323,0.356249884647662
"S01004645",981,1183,202,0.170752324598478,0.153759737013721
"S01004646",741,822,81,0.0985401459854015,0.354375675758045
"S01004647",1339,1755,416,0.237037037037037,0.0668397107951084
"S01004648",918,1072,154,0.14365671641791,0.212069864281308
"S01004649",550,676,126,0.186390532544379,0.127104209955011
"S01004650",805,879,74,0.0841865756541524,0.415020981305762
"S01004651",919,1017,98,0.0963618485742379,0.363032565387909
"S01004652",673,978,305,0.311860940695297,0.0238101479696684
"S01004653",622,695,73,0.105035971223022,0.329652065318673
"S01004654",796,904,108,0.119469026548673,0.280185962219935
"S01004655",841,1020,179,0.175490196078431,0.145197199632687
"S01004656",525,605,80,0.132231404958678,0.242124806993232
"S01004657",726,810,84,0.103703703703704,0.334592358496651
"S01004658",901,1017,116,0.114060963618486,0.297877966599858
"S01004659",494,546,52,0.0952380952380952,0.367572542382869
"S01004660",699,807,108,0.133828996282528,0.237703956372245
"S01004661",641,761,120,0.157687253613666,0.179776833819238
"S01004662",905,1039,134,0.128970163618864,0.251379765334978
"S01004663",513,599,86,0.143572621035058,0.212278215067182
"S01004664",615,692,77,0.111271676300578,0.307390338497939
"S01004665",718,813,95,0.116851168511685,0.288628349891129
"S01004666",737,872,135,0.154816513761468,0.185998751585676
"S01004667",655,757,102,0.134742404227213,0.235209145914694
"S01004668",821,939,118,0.12566560170394,0.261081229077923
"S01004669",725,831,106,0.127557160048135,0.255487600714855
"S01004670",790,937,147,0.156883671291355,0.181499320738189
"S01004671",862,980,118,0.120408163265306,0.277211920315655
"S01004672",630,744,114,0.153225806451613,0.189529204197192
"S01004673",873,1007,134,0.133068520357498,0.239799200891601
"S01004674",813,922,109,0.11822125813449,0.284181789965763
"S01004675",868,974,106,0.108829568788501,0.315942232761979
"S01004676",741,820,79,0.0963414634146341,0.363114470164538
"S01004677",781,878,97,0.110478359908884,0.310145282533017
"S01004678",738,840,102,0.121428571428571,0.27401274135794
"S01004679",480,526,46,0.0874524714828897,0.400456117262743
"S01004680",783,956,173,0.180962343096234,0.135843448452625
"S01004681",675,834,159,0.190647482014388,0.120608307193218
"S01004682",520,623,103,0.165329052969502,0.164116773315724
"S01004683",684,752,68,0.0904255319148936,0.38759896731584
"S01004684",713,816,103,0.126225490196078,0.259414179607013
"S01004685",504,581,77,0.132530120481928,0.241292620807917
"S01004686",712,783,71,0.0906768837803321,0.386529207040312
"S01004687",792,859,67,0.0779976717112922,0.443935808834774
"S01004688",683,791,108,0.13653603034134,0.230378635581978
"S01004689",944,1061,117,0.110273327049953,0.310860902814154
"S01004690",484,623,139,0.223113964686998,0.0800890514147186
"S01004691",792,840,48,0.0571428571428571,0.555212142112598
"S01004692",674,732,58,0.0792349726775956,0.438014164323675
"S01004693",798,866,68,0.0785219399538106,0.441417953883397
"S01004694",610,661,51,0.0771558245083207,0.448005922475435
"S01004695",758,823,65,0.0789793438639125,0.439231728268762
"S01004696",840,951,111,0.116719242902208,0.289059795600292
"S01004697",853,922,69,0.0748373101952278,0.459389538698142
"S01004698",559,659,100,0.151745068285281,0.192869668010522
"S01004699",730,867,137,0.158016147635525,0.179076099541885
"S01004700",720,802,82,0.102244389027431,0.340080148399881
"S01004701",441,614,173,0.281758957654723,0.0365344171521486
"S01004702",567,625,58,0.0928,0.377598634836603
"S01004703",684,838,154,0.183770883054893,0.131256503456222
"S01004704",573,690,117,0.169565217391304,0.155975114207999
"S01004705",890,1017,127,0.124877089478859,0.26344534991225
"S01004706",477,578,101,0.174740484429066,0.146522866432668
"S01004707",975,1061,86,0.0810556079170594,0.429429937684872
"S01004708",700,781,81,0.10371318822023,0.334556953958483
"S01004709",716,791,75,0.0948166877370417,0.369288163775153
"S01004710",895,1005,110,0.109452736318408,0.313739886856226
"S01004711",760,878,118,0.134396355353075,0.236151530042677
"S01004712",551,596,45,0.075503355704698,0.456092983475484
"S01004713",692,804,112,0.139303482587065,0.2231004555552
"S01004714",704,766,62,0.0809399477806789,0.429970732817742
"S01004715",764,850,86,0.101176470588235,0.344147269854889
"S01004716",845,940,95,0.101063829787234,0.344578799419598
"S01004717",719,792,73,0.0921717171717172,0.38022186516803
"S01004718",917,1022,105,0.102739726027397,0.338208406892659
"S01004719",694,767,73,0.0951760104302477,0.367824848748041
"S01004720",656,769,113,0.146944083224967,0.204068041167101
"S01004721",562,673,111,0.164933135215453,0.164896908468315
"S01004722",668,773,105,0.135834411384217,0.232257467138791
"S01004723",473,615,142,0.230894308943089,0.0724202883407165
"S01004724",895,984,89,0.0904471544715447,0.387506836496023
"S01004725",553,652,99,0.151840490797546,0.192652813455481
"S01004726",540,633,93,0.146919431279621,0.204127021221657
"S01004727",832,909,77,0.0847084708470847,0.412661954388118
"S01004728",559,676,117,0.173076923076923,0.149503417201329
"S01004729",606,699,93,0.133047210300429,0.239858152493525
"S01004730",920,1176,256,0.217687074829932,0.0858628018318841
"S01004731",764,918,154,0.167755991285403,0.159406774338907
"S01004732",579,673,94,0.139673105497771,0.222144208376832
"S01004733",752,882,130,0.147392290249433,0.202998371818809
"S01004734",510,573,63,0.109947643979058,0.312000680537942
"S01004735",848,936,88,0.094017094017094,0.37256326865129
"S01004736",680,788,108,0.137055837563452,0.228995502152267
"S01004737",712,791,79,0.0998735777496839,0.349168535515431
"S01004738",607,721,114,0.158113730929265,0.178868664154187
"S01004739",714,793,79,0.0996216897856242,0.350146866846598
"S01004740",636,754,118,0.156498673740053,0.182329817716163
"S01004741",591,678,87,0.128318584070796,0.253266570818864
"S01004742",898,976,78,0.0799180327868853,0.434775626937003
"S01004743",846,934,88,0.0942184154175589,0.371736211087513
"S01004744",607,669,62,0.0926756352765321,0.378116590408134
"S01004745",769,882,113,0.1281179138322,0.253850221503834
"S01004746",767,853,86,0.100820633059789,0.345512153013915
"S01004747",762,817,55,0.0673194614443084,0.498114458642891
"S01004748",524,663,139,0.209653092006033,0.0950993581515902
"S01004749",597,697,100,0.143472022955524,0.21252769415389
"S01004750",666,763,97,0.127129750982962,0.256741995361426
"S01004751",749,865,116,0.134104046242775,0.236950212407274
"S01004752",727,862,135,0.15661252900232,0.182083859543767
"S01004753",681,826,145,0.175544794188862,0.145101080328274
"S01004754",653,723,70,0.0968188105117566,0.361200913337243
"S01004755",660,740,80,0.108108108108108,0.318509329699947
"S01004756",555,646,91,0.140866873065015,0.219080968052018
"S01004757",857,981,124,0.126401630988787,0.258891710814587
"S01004758",923,1005,82,0.081592039800995,0.426929724081728
"S01004759",564,674,110,0.163204747774481,0.168341841827481
"S01004760",698,773,75,0.0970245795601552,0.360378843338091
"S01004761",517,575,58,0.100869565217391,0.345324175885254
"S01004762",622,699,77,0.110157367668097,0.311266290086241
"S01004763",790,924,134,0.145021645021645,0.20871381704283
"S01004764",736,822,86,0.104622871046229,0.331176847676438
"S01004765",920,1061,141,0.132893496701225,0.240283768410761
"S01004766",685,831,146,0.175691937424789,0.144842321536208
"S01004767",646,714,68,0.0952380952380952,0.367572542382869
"S01004768",944,1073,129,0.12022367194781,0.27779391174911
"S01004769",493,618,125,0.202265372168285,0.104372104851032
"S01004770",550,636,86,0.135220125786164,0.233913743024193
"S01004771",732,826,94,0.113801452784504,0.298751667071402
"S01004772",570,643,73,0.11353032659409,0.299666936093609
"S01004773",748,854,106,0.124121779859485,0.265727971199857
"S01004774",944,1037,93,0.0896817743490839,0.390780045469407
"S01004775",802,985,183,0.185786802030457,0.128050529267708
"S01004776",746,871,125,0.143513203214696,0.212425536927195
"S01004777",562,663,101,0.152337858220211,0.191526058687536
"S01004778",694,782,88,0.112531969309463,0.303058991687435
"S01004779",746,818,72,0.0880195599022005,0.397974492881108
"S01004780",509,554,45,0.0812274368231047,0.4286276430091
"S01004781",769,877,108,0.123147092360319,0.268699874972656
"S01004782",712,839,127,0.151370679380215,0.193722617348223
"S01004783",897,1050,153,0.145714285714286,0.20702912172963
"S01004784",681,808,127,0.157178217821782,0.180866240492776
"S01004785",556,660,104,0.157575757575758,0.180014944291079
"S01004786",548,605,57,0.0942148760330579,0.371750737111691
"S01004787",925,1156,231,0.199826989619377,0.107606619115952
"S01004788",750,825,75,0.0909090909090909,0.385543289429532
"S01004789",935,1075,140,0.130232558139535,0.247760156234142
"S01004790",706,810,104,0.128395061728395,0.25304445310095
"S01004791",536,664,128,0.192771084337349,0.117480856267308
"S01004792",628,732,104,0.14207650273224,0.216015854197051
"S01004793",797,1034,237,0.229206963249516,0.0740248994898773
"S01004794",667,742,75,0.101078167115903,0.344523845740984
"S01004795",919,1048,129,0.123091603053435,0.268869962980907
"S01004796",717,825,108,0.130909090909091,0.245839730512627
"S01004797",678,759,81,0.106719367588933,0.323503646023685
"S01004798",805,964,159,0.1649377593361,0.164887777652197
"S01004799",580,684,104,0.152046783625731,0.19218474792554
"S01004800",682,804,122,0.151741293532338,0.192878250924676
"S01004801",678,766,88,0.114882506527415,0.295127203285899
"S01004802",811,961,150,0.156087408949011,0.183220753740466
"S01004803",774,939,165,0.175718849840256,0.144795039648944
"S01004804",854,1011,157,0.155291790306627,0.184955457656265
"S01004805",638,735,97,0.131972789115646,0.242847365458473
"S01004806",511,575,64,0.111304347826087,0.307277354025779
"S01004807",503,575,72,0.125217391304348,0.262422702501269
"S01004808",658,816,158,0.193627450980392,0.116240467673077
"S01004809",438,518,80,0.154440154440154,0.186828663736837
"S01004810",636,730,94,0.128767123287671,0.251966356074847
"S01004811",613,663,50,0.0754147812971342,0.456530146635078
"S01004812",783,936,153,0.163461538461538,0.167825957325105
"S01004813",853,971,118,0.121524201853759,0.273714631007863
"S01004814",854,957,103,0.107628004179728,0.320228019294424
"S01004815",692,789,97,0.122940430925222,0.269333833444618
"S01004816",765,844,79,0.0936018957345972,0.374274195291659
"S01004817",529,665,136,0.204511278195489,0.10147060909738
"S01004818",775,917,142,0.154852780806979,0.185918954442296
"S01004819",635,741,106,0.143049932523617,0.213577339921404
"S01004820",1040,1141,101,0.0885188431200701,0.395801056212351
"S01004821",937,1035,98,0.0946859903381643,0.369821717297485
"S01004822",683,760,77,0.101315789473684,0.343614208764069
"S01004823",787,855,68,0.0795321637426901,0.43660245792203
"S01004824",752,813,61,0.0750307503075031,0.458429915060793
"S01004825",597,663,66,0.0995475113122172,0.350435445449007
"S01004826",681,898,217,0.241648106904232,0.0629082715006173
"S01004827",656,729,73,0.100137174211248,0.348147363451892
"S01004828",943,1052,109,0.10361216730038,0.334934226030439
"S01004829",761,832,71,0.0853365384615385,0.409839020383555
"S01004830",682,758,76,0.100263852242744,0.347657569969268
"S01004831",826,931,105,0.112781954887218,0.302206404164121
"S01004832",611,673,62,0.0921248142644874,0.380418352300358
"S01004833",828,958,130,0.135699373695198,0.232620656504634
"S01004834",742,840,98,0.116666666666667,0.289231901097091
"S01004835",607,766,159,0.20757180156658,0.097633580053628
"S01004836",681,763,82,0.107470511140236,0.320793632709409
"S01004837",798,867,69,0.0795847750865052,0.436352972454899
"S01004838",913,1029,116,0.112730806608358,0.302380671900981
"S01004839",869,970,101,0.104123711340206,0.33302774894098
"S01004840",654,729,75,0.102880658436214,0.337677559255518
"S01004841",819,891,72,0.0808080808080808,0.430588054406448
"S01004842",402,583,181,0.310463121783877,0.0242982492801677
"S01004843",680,743,63,0.0847913862718708,0.41228828004152
"S01004844",879,979,100,0.102145045965271,0.34045665879043
"S01004845",745,818,73,0.089242053789731,0.392671779693841
"S01004846",714,789,75,0.0950570342205323,0.368308791598374
"S01004847",862,922,60,0.0650759219088937,0.510227012920117
"S01004848",674,720,46,0.0638888888888889,0.516742284691916
"S01004849",513,641,128,0.199687987519501,0.107793694208724
"S01004850",785,857,72,0.0840140023337223,0.415803698725647
"S01004851",584,650,66,0.101538461538462,0.342763765090748
"S01004852",688,785,97,0.123566878980892,0.267416262645751
"S01004853",705,777,72,0.0926640926640927,0.378164695620456
"S01004854",910,1017,107,0.105211406096362,0.329006436237356
"S01004855",611,689,78,0.113207547169811,0.300759866478133
"S01004856",674,721,47,0.0651872399445215,0.509619829430249
"S01004857",897,959,62,0.0646506777893639,0.512552503047269
"S01004858",885,1014,129,0.127218934911243,0.256479794479813
"S01004859",899,1079,180,0.166821130676552,0.161206470866241
"S01004860",324,515,191,0.370873786407767,0.00971354623414926
"S01004861",781,876,95,0.108447488584475,0.31729941915938
"S01004862",656,738,82,0.111111111111111,0.307946147657439
"S01004863",929,1046,117,0.111854684512428,0.30537979176648
"S01004864",550,636,86,0.135220125786164,0.233913743024193
"S01004865",747,828,81,0.0978260869565217,0.357192762292385
"S01004866",890,1002,112,0.111776447105788,0.305648909846556
"S01004867",766,868,102,0.117511520737327,0.286477451512291
"S01004868",718,818,100,0.122249388753056,0.271463475950036
"S01004869",858,951,93,0.0977917981072555,0.357328543471194
"S01004870",906,1016,110,0.108267716535433,0.317939800427513
"S01004871",724,824,100,0.121359223300971,0.274229104204692
"S01004872",806,912,106,0.116228070175439,0.290671220886349
"S01004873",770,836,66,0.0789473684210526,0.439384241931812
"S01004874",789,928,139,0.149784482758621,0.197374148724066
"S01004875",671,793,122,0.153846153846154,0.188145280374965
"S01004876",963,1078,115,0.106679035250464,0.323649740200569
"S01004877",735,830,95,0.114457831325301,0.296546270883275
"S01004878",704,811,107,0.13193588162762,0.242950641038152
"S01004879",647,765,118,0.154248366013072,0.187252858080065
"S01004880",633,812,179,0.220443349753695,0.0828851652670768
"S01004881",744,871,127,0.145809414466131,0.206798700504679
"S01004882",501,551,50,0.0907441016333938,0.38624357675055
"S01004883",619,836,217,0.259569377990431,0.0495271931342433
"S01004884",537,636,99,0.155660377358491,0.184149990383409
"S01004885",568,674,106,0.15727002967359,0.180669312422733
"S01004886",786,958,172,0.179540709812109,0.138219834813701
"S01004887",474,534,60,0.112359550561798,0.303648294702553
"S01004888",580,726,146,0.201101928374656,0.105904332831617
"S01004889",872,979,107,0.10929519918284,0.314295332353828
"S01004890",670,831,161,0.193742478941035,0.116074758607406
"S01004891",894,1032,138,0.133720930232558,0.238000689399111
"S01004892",718,862,144,0.167053364269142,0.160757700062751
"S01004893",720,800,80,0.1,0.3486784401
"S01004894",697,806,109,0.135235732009926,0.233871533279458
"S01004895",810,962,152,0.158004158004158,0.179101601147411
"S01004896",919,1034,115,0.111218568665377,0.307574074787812
"S01004897",557,633,76,0.120063191153239,0.278301054280702
"S01004898",964,1116,152,0.136200716845878,0.231274842043311
"S01004899",690,781,91,0.11651728553137,0.289721395634202
"S01004900",686,783,97,0.123882503192848,0.266454792836506
"S01004901",689,893,204,0.228443449048152,0.0747614352387905
"S01004902",688,815,127,0.155828220858896,0.183784251952797
"S01004903",604,693,89,0.128427128427128,0.252951372432846
"S01004904",970,1163,193,0.165950128976784,0.162899666570395
"S01004905",991,1148,157,0.136759581881533,0.229782877796914
"S01004906",766,921,155,0.168295331161781,0.158376738205838
"S01004907",594,766,172,0.224543080939948,0.0786279139108099
"S01004908",688,768,80,0.104166666666667,0.332868103801781
"S01004909",914,1060,146,0.137735849056604,0.227197372587037
"S01004910",834,946,112,0.118393234672304,0.283628025997317
"S01004911",673,855,182,0.212865497076023,0.0913039349742742
"S01004912",710,819,109,0.133089133089133,0.239742190760387
"S01004913",615,692,77,0.111271676300578,0.307390338497939
"S01004914",569,733,164,0.223738062755798,0.0794479906074891
"S01004915",533,662,129,0.194864048338369,0.114470135228083
"S01004916",735,862,127,0.147331786542923,0.203142471814883
"S01004917",502,592,90,0.152027027027027,0.192229530054856
"S01004918",492,619,127,0.205169628432956,0.100633954143748
"S01004919",486,583,97,0.166380789022298,0.162060489008615
"S01004920",916,1036,120,0.115830115830116,0.291982741926197
"S01004921",670,785,115,0.146496815286624,0.205140523544392
"S01004922",628,794,166,0.209068010075567,0.095805714277904
"S01004923",706,903,197,0.218161683277962,0.0853433148393641
"S01004924",815,948,133,0.140295358649789,0.220542713653333
"S01004925",516,586,70,0.119453924914676,0.280234019500762
"S01004926",810,1062,252,0.23728813559322,0.0666200602819741
"S01004927",942,1060,118,0.111320754716981,0.307220629913363
"S01004928",424,655,231,0.352671755725191,0.0129194958274414
"S01004929",673,747,74,0.0990629183400268,0.352325943888278
"S01004930",593,716,123,0.171787709497207,0.151850669335195
"S01004931",832,993,161,0.162134944612286,0.170506436499715
"S01004932",701,839,138,0.164481525625745,0.165790855048314
"S01004933",825,972,147,0.151234567901235,0.1940335530015
"S01004934",631,734,103,0.140326975476839,0.220461619442044
"S01004935",694,762,68,0.089238845144357,0.392685613934538
"S01004936",836,968,132,0.136363636363636,0.230839009056934
"S01004937",482,572,90,0.157342657342657,0.180513669406631
"S01004938",739,834,95,0.113908872901679,0.29838973418624
"S01004939",572,643,71,0.110419906687403,0.310349148880028
"S01004940",519,559,40,0.0715563506261181,0.475943609173221
"S01004941",617,708,91,0.128531073446328,0.25264986088107
"S01004942",963,1051,88,0.0837297811607992,0.41709569846612
"S01004943",816,916,100,0.109170305676856,0.314736311492022
"S01004944",505,537,32,0.0595903165735568,0.540967188155194
"S01004945",540,646,106,0.164086687306502,0.166575995836753
"S01004946",565,648,83,0.128086419753086,0.25394193205452
"S01004947",628,766,138,0.180156657963446,0.137185667597253
"S01004948",502,638,136,0.213166144200627,0.0909557971092236
"S01004949",535,614,79,0.128664495114007,0.252263320977267
"S01004950",463,587,124,0.211243611584327,0.0932027867097284
"S01004951",625,701,76,0.108416547788873,0.317409553219746
"S01004952",806,1045,239,0.228708133971292,0.0745053593259559
"S01004953",783,998,215,0.215430861723447,0.08837149613847
"S01004954",711,886,175,0.197516930022573,0.110753838887294
"S01004955",617,737,120,0.162822252374491,0.169112909627021
"S01004956",628,743,115,0.154777927321669,0.18608368585633
"S01004957",576,715,139,0.194405594405594,0.115123614412824
"S01004958",712,1005,293,0.291542288557214,0.0318521915513353
"S01004959",520,754,234,0.310344827586207,0.0243399665835865
"S01004960",496,630,134,0.212698412698413,0.0914979303020232
"S01004961",532,718,186,0.259052924791086,0.0498737335255573
"S01004962",520,619,99,0.159935379644588,0.175035825110761
"S01004963",510,603,93,0.154228855721393,0.187296059145312
"S01004964",930,1029,99,0.0962099125364431,0.36364342363617
"S01004965",775,873,98,0.112256586483391,0.304000703065675
"S01004966",758,825,67,0.0812121212121212,0.428699099068653
"S01004967",634,717,83,0.115760111576011,0.292214001987225
"S01004968",527,618,91,0.147249190938511,0.203339336090257
"S01004969",851,963,112,0.116303219106957,0.290424151767131
"S01004970",708,805,97,0.120496894409938,0.276932402395764
"S01004971",895,1051,156,0.148430066603235,0.200541007689039
"S01004972",712,812,100,0.123152709359606,0.268682662923904
"S01004973",832,997,165,0.165496489468405,0.1637878491372
"S01004974",744,950,206,0.216842105263158,0.0867947192226805
"S01004975",670,795,125,0.157232704402516,0.180749348442623
"S01004976",691,812,121,0.149014778325123,0.199168283887545
"S01004977",911,1036,125,0.120656370656371,0.276430663165644
"S01004978",884,1076,192,0.178438661710037,0.140087678018143
"S01004979",800,1000,200,0.2,0.1073741824
"S01004980",957,1177,220,0.186915887850467,0.126285866753906
"S01004981",865,1007,142,0.141012909632572,0.218708856093012
"S01004982",630,774,144,0.186046511627907,0.127642672239099
"S01004983",832,981,149,0.151885830784913,0.192549851982958
"S01004984",703,851,148,0.173913043478261,0.147998614369944
"S01004985",659,768,109,0.141927083333333,0.216392371073263
"S01004986",601,719,118,0.164116828929068,0.16651594109066
"S01004987",443,561,118,0.210338680926916,0.0942776285237732
"S01004988",453,599,146,0.243739565943239,0.0611946980538251
"S01004989",496,693,197,0.284271284271284,0.0352764130246361
"S01004990",469,558,89,0.159498207885305,0.175948852082055
"S01004991",528,615,87,0.141463414634146,0.2175645173376
"S01004992",826,902,76,0.0842572062084257,0.414701014487385
"S01004993",677,779,102,0.130937098844673,0.245760515958448
"S01004994",733,873,140,0.160366552119129,0.174139506497023
"S01004995",826,1007,181,0.17974180734856,0.137881426425289
"S01004996",530,715,185,0.258741258741259,0.0500839159439448
"S01004997",802,943,141,0.149522799575822,0.197982477897757
"S01004998",737,893,156,0.174692049272116,0.14660888461887
"S01004999",803,960,157,0.163541666666667,0.167665273764736
"S01005000",529,596,67,0.11241610738255,0.303454877885608
"S01005001",938,1114,176,0.157989228007181,0.17913336139615
"S01005002",728,849,121,0.142520612485277,0.214900235140928
"S01005003",785,977,192,0.196519959058342,0.112137515642397
"S01005004",537,627,90,0.143540669856459,0.212357424094367
"S01005005",909,1018,109,0.107072691552063,0.322226350242032
"S01005006",499,631,132,0.20919175911252,0.0956559223721181
"S01005007",769,921,152,0.165038002171553,0.164689949374202
"S01005008",1125,1450,325,0.224137931034483,0.0790396852460788
"S01005009",563,694,131,0.188760806916427,0.123449474044841
"S01005010",544,667,123,0.184407796101949,0.130235882674797
"S01005011",538,625,87,0.1392,0.223368837114348
"S01005012",583,797,214,0.268506900878294,0.0438634041766642
"S01005013",593,727,134,0.184319119669876,0.13037755280703
"S01005014",730,888,158,0.177927927927928,0.140960990712218
"S01005015",571,690,119,0.172463768115942,0.150615675905861
"S01005016",700,893,193,0.216125419932811,0.0875922760098403
"S01005017",656,764,108,0.141361256544503,0.217823538103017
"S01005018",574,658,84,0.127659574468085,0.25518784701564
"S01005019",864,1156,292,0.252595155709343,0.0543950128821746
"S01005020",787,966,179,0.185300207039337,0.128817853865373
"S01005021",862,1018,156,0.153241650294695,0.18949374470671
"S01005022",622,761,139,0.182654402102497,0.133062990349971
"S01005023",526,631,105,0.166402535657686,0.16201821722999
"S01005024",824,1001,177,0.176823176823177,0.142866808183782
"S01005025",619,732,113,0.154371584699454,0.186980225675986
"S01005026",590,669,79,0.118086696562033,0.284615756188618
"S01005027",596,794,198,0.249370277078086,0.0567881306899496
"S01005028",542,634,92,0.145110410094637,0.208497228587939
"S01005029",784,1096,312,0.284671532846715,0.0350796365696667
"S01005030",930,1063,133,0.125117591721543,0.262722241213877
"S01005031",556,724,168,0.232044198895028,0.071344788337411
"S01005032",822,936,114,0.121794871794872,0.272872448602819
"S01005033",614,766,152,0.198433420365535,0.109495435455265
"S01005034",730,901,171,0.189789123196448,0.121893540426351
"S01005035",841,997,156,0.156469408224674,0.182393087436017
"S01005036",502,587,85,0.144804088586031,0.209245515454134
"S01005037",757,1135,378,0.333039647577093,0.0174180759414445
"S01005038",813,984,171,0.173780487804878,0.148236267654427
"S01005039",1006,1163,157,0.134995700773861,0.234521498188039
"S01005040",771,1126,355,0.315275310834813,0.0226547813689769
"S01005041",391,710,319,0.449295774647887,0.00256557128875009
"S01005042",801,907,106,0.116868798235943,0.288570738071161
"S01005043",686,815,129,0.158282208588957,0.178511035677485
"S01005044",823,1021,198,0.193927522037218,0.115808631934115
"S01005045",853,1012,159,0.157114624505929,0.181002755593754
"S01005046",918,1138,220,0.193321616871705,0.116682087811812
"S01005047",713,1090,377,0.345871559633028,0.0143426803351134
"S01005048",596,779,183,0.234916559691913,0.0687207705790082
"S01005049",636,883,247,0.279728199320498,0.0375806355718046
"S01005050",852,1060,208,0.19622641509434,0.112547873822436
"S01005051",807,987,180,0.182370820668693,0.133525379361217
"S01005052",611,698,87,0.124641833810888,0.264154416483347
"S01005053",805,1034,229,0.22147001934236,0.0818000211760044
"S01005054",569,638,69,0.108150470219436,0.318358079932028
"S01005055",731,850,119,0.14,0.221301578888031
"S01005056",569,880,311,0.353409090909091,0.0127730891234367
"S01005057",686,858,172,0.2004662004662,0.106750097062763
"S01005058",629,782,153,0.195652173913043,0.113354541297751
"S01005059",491,572,81,0.141608391608392,0.217197405576608
"S01005060",673,795,122,0.153459119496855,0.189007638367547
"S01005061",982,1168,186,0.159246575342466,0.176476324514001
"S01005062",470,536,66,0.123134328358209,0.268738991116432
"S01005063",480,606,126,0.207920792079208,0.097204446597545
"S01005064",752,821,69,0.0840438489646772,0.415668232462808
"S01005065",727,967,240,0.248190279214064,0.0576871877684809
"S01005066",701,875,174,0.198857142857143,0.108917997845117
"S01005067",401,562,161,0.286476868327402,0.0342042892581989
"S01005068",640,749,109,0.145527369826435,0.207482543277193
"S01005069",542,698,156,0.223495702005731,0.0796963880745557
"S01005070",724,962,238,0.247401247401247,0.0582954879193568
"S01005071",640,845,205,0.242603550295858,0.0621201721140779
"S01005072",553,649,96,0.147919876733436,0.201745726983182
"S01005073",705,885,180,0.203389830508475,0.102910209646153
"S01005074",724,830,106,0.127710843373494,0.255037908509958
"S01005075",449,619,170,0.274636510500808,0.0403233791912748
"S01005076",714,829,115,0.138721351025332,0.224613994974666
"S01005077",577,739,162,0.219215155615697,0.0842003210832368
"S01005078",655,788,133,0.168781725888325,0.157452958388723
"S01005079",620,743,123,0.165545087483176,0.163692490896173
"S01005080",459,549,90,0.163934426229508,0.166879661774604
"S01005081",587,733,146,0.199181446111869,0.108477899218846
"S01005082",631,743,112,0.150740242261104,0.195166581348994
"S01005083",874,994,120,0.120724346076459,0.276217049798869
"S01005084",578,690,112,0.16231884057971,0.170132575634378
"S01005085",535,610,75,0.122950819672131,0.26930193262521
"S01005086",653,813,160,0.19680196801968,0.111744551512896
"S01005087",475,548,73,0.133211678832117,0.239403508845564
"S01005088",567,629,62,0.0985691573926868,0.354261644631354
"S01005089",756,865,109,0.126011560693642,0.260050013324856
"S01005090",798,940,142,0.151063829787234,0.194424225462645
"S01005091",655,740,85,0.114864864864865,0.295186031651339
"S01005092",625,725,100,0.137931034482759,0.226683603446804
"S01005093",738,836,98,0.117224880382775,0.287409317801283
"S01005094",478,561,83,0.14795008912656,0.201674204967799
"S01005095",880,1070,190,0.177570093457944,0.141575774013208
"S01005096",541,648,107,0.165123456790123,0.164521474198262
"S01005097",648,790,142,0.179746835443038,0.137872974675321
"S01005098",702,818,116,0.141809290953545,0.21668960832926
"S01005099",788,904,116,0.128318584070796,0.253266570818864
"S01005100",556,631,75,0.118858954041204,0.282133283576276
"S01005101",751,891,140,0.15712682379349,0.180976560325433
"S01005102",877,1041,164,0.157540826128722,0.180089602113631
"S01005103",785,1095,310,0.28310502283105,0.0358554663677871
"S01005104",858,1138,280,0.246045694200351,0.0593540362899804
"S01005105",811,960,149,0.155208333333333,0.185138274480725
"S01005106",482,589,107,0.181663837011885,0.134684442988625
"S01005107",519,622,103,0.165594855305466,0.163594889065419
"S01005108",552,593,41,0.0691399662731872,0.48847668947932
"S01005109",800,1005,205,0.203980099502488,0.102150207310164
"S01005110",913,1096,183,0.166970802919708,0.160917113566936
"S01005111",497,574,77,0.134146341463415,0.23683449805499
"S01005112",759,994,235,0.236418511066398,0.0673835542805477
"S01005113",964,1107,143,0.129177958446251,0.250780711523764
"S01005114",895,996,101,0.10140562248996,0.343270884389782
"S01005115",777,954,177,0.185534591194969,0.12844773218644
"S01005116",605,701,96,0.136947218259629,0.229283903494227
"S01005117",634,747,113,0.151271753681392,0.193948560535643
"S01005118",680,864,184,0.212962962962963,0.0911909420611738
"S01005119",623,731,108,0.147742818057456,0.202165338363834
"S01005120",600,696,96,0.137931034482759,0.226683603446804
"S01005121",774,929,155,0.166846071044133,0.161158221837715
"S01005122",709,854,145,0.169789227166276,0.155554881713772
"S01005123",680,798,118,0.147869674185464,0.201864622318871
"S01005124",697,802,105,0.130922693266833,0.245801256235465
"S01005125",688,901,213,0.236403995560488,0.0673963648327925
"S01005126",520,612,92,0.150326797385621,0.196118794420838
"S01005127",570,670,100,0.149253731343284,0.19860973398339
"S01005128",740,892,152,0.170403587443946,0.154407593204058
"S01005129",810,945,135,0.142857142857143,0.214058315601308
"S01005130",590,735,145,0.197278911564626,0.111082776302991
"S01005131",730,926,196,0.211663066954644,0.0927083249610589
"S01005132",645,769,124,0.161248374512354,0.172319231191786
"S01005133",445,540,95,0.175925925925926,0.144431696188408
"S01005134",897,1041,144,0.138328530259366,0.225640542563006
"S01005135",645,790,145,0.183544303797468,0.131621317430819
"S01005136",789,961,172,0.1789802289282,0.139166964778012
"S01005137",767,979,212,0.216547497446374,0.0871217762838203
"S01005138",961,1148,187,0.162891986062718,0.168972097862996
"S01005139",566,713,147,0.20617110799439,0.0993731401046209
"S01005140",599,770,171,0.222077922077922,0.0811635383854421
"S01005141",762,937,175,0.186766275346852,0.12651843306291
"S01005142",554,715,161,0.225174825174825,0.0779896963209839
"S01005143",887,1055,168,0.159241706161137,0.176486545318269
"S01005144",956,1172,216,0.184300341296928,0.130407571065657
"S01005145",706,851,145,0.170387779083431,0.154437018840215
"S01005146",637,796,159,0.199748743718593,0.107711889885174
"S01005147",818,1016,198,0.19488188976378,0.114444771726025
"S01005148",617,707,90,0.127298444130127,0.256246240485857
"S01005149",553,633,80,0.126382306477093,0.258948984890495
"S01005150",600,690,90,0.130434782608696,0.247184706121866
"S01005151",681,765,84,0.109803921568627,0.312504854111276
"S01005152",684,808,124,0.153465346534653,0.188993735686918
"S01005153",668,836,168,0.200956937799043,0.106096693750757
"S01005154",555,661,106,0.16036308623298,0.174146694858996
"S01005155",697,798,101,0.1265664160401,0.258403783050422
"S01005156",663,770,107,0.138961038961039,0.223989691871077
"S01005157",855,995,140,0.14070351758794,0.219497884962755
"S01005158",740,787,47,0.059720457433291,0.54021902371119
"S01005159",874,1008,134,0.132936507936508,0.240164606634603
"S01005160",975,1184,209,0.17652027027027,0.143393390323723
"S01005161",1025,1142,117,0.102451838879159,0.339295121158091
"S01005162",905,1038,133,0.128131021194605,0.253812061736381
"S01005163",536,623,87,0.139646869983949,0.222211960150236
"S01005164",872,971,99,0.101956745623069,0.341171347070604
"S01005165",710,830,120,0.144578313253012,0.209798589197744
"S01005166",969,1153,184,0.159583694709454,0.175769977672712
"S01005167",869,1058,189,0.178638941398866,0.139746547577367
"S01005168",617,743,126,0.169582772543742,0.155942144653976
"S01005169",591,660,69,0.104545454545455,0.331463302731296
"S01005170",799,867,68,0.0784313725490196,0.441851993134814
"S01005171",905,1047,142,0.135625596943649,0.232819297922089
"S01005172",960,1301,341,0.262106072252114,0.0478563271728886
"S01005173",661,747,86,0.115127175368139,0.294312411166804
"S01005174",878,1025,147,0.143414634146341,0.212670134210376
"S01005175",641,730,89,0.121917808219178,0.272490705908668
"S01005176",636,722,86,0.119113573407202,0.281319075025659
"S01005177",897,1144,247,0.215909090909091,0.0878343083642255
"S01005178",882,997,115,0.115346038114343,0.293585274183474
"S01005179",882,1068,186,0.174157303370787,0.147561589395053
"S01005180",843,974,131,0.134496919917864,0.235877316041253
"S01005181",686,940,254,0.270212765957447,0.0428511637599577
"S01005182",722,879,157,0.178612059158134,0.139792291816509
"S01005183",867,1047,180,0.171919770773639,0.151608711925198
"S01005184",1006,1146,140,0.12216404886562,0.271727523625833
"S01005185",506,568,62,0.109154929577465,0.314790640537657
"S01005186",713,777,64,0.0823680823680824,0.423335910875647
"S01005187",960,1046,86,0.0822179732313576,0.424028927165739
"S01005188",958,1027,69,0.0671859785783836,0.498827806679963
"S01005189",887,1021,134,0.131243878550441,0.244894356705296
"S01005190",882,979,97,0.0990806945863126,0.352256433188573
"S01005191",853,1019,166,0.162904808635918,0.168946217000352
"S01005192",810,897,87,0.096989966555184,0.360517008190619
"S01005193",792,940,148,0.157446808510638,0.1802906813049
"S01005194",564,625,61,0.0976,0.358088906088575
"S01005195",961,1045,84,0.0803827751196172,0.432584518032208
"S01005196",692,885,193,0.218079096045198,0.0854335076497727
"S01005197",682,833,151,0.181272509003601,0.1353298911487
"S01005198",878,970,92,0.0948453608247423,0.369171202685177
"S01005199",850,970,120,0.123711340206186,0.266975811016249
"S01005200",575,685,110,0.160583941605839,0.173689166857525
"S01005201",811,945,134,0.141798941798942,0.216715740935146
"S01005202",861,995,134,0.134673366834171,0.235396882582506
"S01005203",917,1021,104,0.101860920666014,0.341535565965594
"S01005204",518,596,78,0.130872483221477,0.245943302302615
"S01005205",780,978,198,0.202453987730061,0.104125590909316
"S01005206",898,958,60,0.0626304801670146,0.523730994012101
"S01005207",899,1010,111,0.10990099009901,0.312164260535622
"S01005208",579,721,142,0.196948682385576,0.111540603533552
"S01005209",740,854,114,0.133489461358314,0.238637389978071
"S01005210",884,1010,126,0.124752475247525,0.263820726715549
"S01005211",600,761,161,0.211563731931669,0.092825209085169
"S01005212",607,709,102,0.143864598025388,0.211555616111386
"S01005213",895,990,95,0.095959595959596,0.364651838210422
"S01005214",735,962,227,0.235966735966736,0.0677832940710903
"S01005215",842,950,108,0.113684210526316,0.299147144813395
"S01005216",549,656,107,0.163109756097561,0.168533038479808
"S01005217",769,903,134,0.148394241417497,0.200625390413509
"S01005218",824,947,123,0.129883843717001,0.248755291012891
"S01005219",956,1082,126,0.11645101663586,0.289938785272568
"S01005220",675,773,98,0.126778783958603,0.257776183300605
"S01005221",719,874,155,0.177345537757437,0.141962806840845
"S01005222",688,845,157,0.185798816568047,0.128031635374219
"S01005223",681,792,111,0.140151515151515,0.22091199782605
"S01005224",688,848,160,0.188679245283019,0.123573645774145
"S01005225",874,986,112,0.113590263691684,0.299464383168674
"S01005226",517,616,99,0.160714285714286,0.173419651561802
"S01005227",851,1007,156,0.154915590863952,0.185780828500926
"S01005228",1158,1379,221,0.160261058738216,0.174358422922385
"S01005229",726,935,209,0.223529411764706,0.0796617968782036
"S01005230",700,839,139,0.165673420738975,0.163440917593104
"S01005231",630,818,188,0.229828850855746,0.0734298190207481
"S01005232",815,977,162,0.165813715455476,0.16316629426536
"S01005233",488,668,180,0.269461077844311,0.0432945864155511
"S01005234",903,1124,221,0.196619217081851,0.111999063383816
"S01005235",805,1019,214,0.210009813542689,0.0946709997961891
"S01005236",889,1052,163,0.154942965779468,0.185720657077206
"S01005237",935,1006,71,0.0705765407554672,0.480990281573219
"S01005238",784,853,69,0.0808909730363423,0.430199909974548
"S01005239",783,1026,243,0.236842105263158,0.0670106781176891
"S01005240",821,1059,238,0.224740321057601,0.0784281498791239
"S01005241",892,996,104,0.104417670682731,0.331936613978216
"S01005242",763,977,214,0.219037871033777,0.0843917013388754
"S01005243",769,987,218,0.220871327254306,0.0824312472889767
"S01005244",988,1105,117,0.105882352941176,0.326547727413754
"S01005245",666,958,292,0.304801670146138,0.0263686078144645
"S01005246",851,1031,180,0.17458777885548,0.146794217422002
"S01005247",659,835,176,0.210778443113772,0.0937539104548158
"S01005248",571,688,117,0.170058139534884,0.155051759930185
"S01005249",642,992,350,0.352822580645161,0.012889425455001
"S01005250",699,900,201,0.223333333333333,0.0798631917838443
"S01005251",857,1051,194,0.184586108468126,0.12995142882148
"S01005252",559,660,101,0.153030303030303,0.189967244575699
"S01005253",505,581,76,0.130808950086059,0.246123145764571
"S01005254",625,869,244,0.28078250863061,0.0370341523610265
"S01005255",570,673,103,0.153046062407132,0.189931900752347
"S01005256",662,776,114,0.146907216494845,0.204156250914417
"S01005257",876,1032,156,0.151162790697674,0.194197703030306
"S01005258",1006,1079,73,0.0676552363299351,0.496324096150559
"S01005259",678,776,98,0.126288659793814,0.259226696920806
"S01005260",602,678,76,0.112094395280236,0.30455657085405
"S01005261",578,664,86,0.129518072289157,0.249802965955482
"S01005262",870,1105,235,0.212669683257919,0.0915313243162558
"S01005263",514,621,107,0.172302737520129,0.150909016306715
"S01005264",694,761,67,0.088042049934297,0.397876360667612
"S01005265",512,680,168,0.247058823529412,0.0585612694787653
"S01005266",821,912,91,0.099780701754386,0.349528978626998
"S01005267",861,1010,149,0.147524752475248,0.202683211347898
"S01005268",765,1066,301,0.282363977485929,0.0362278286230143
"S01005269",680,744,64,0.0860215053763441,0.406780168242369
"S01005270",1024,1100,76,0.0690909090909091,0.488734182259312
"S01005271",576,623,47,0.0754414125200642,0.456398667349817
"S01005272",602,698,96,0.137535816618911,0.227724987205442
"S01005273",777,853,76,0.0890973036342321,0.393296314129257
"S01005274",695,755,60,0.0794701986754967,0.436896463825411
"S01005275",483,606,123,0.202970297029703,0.103453470870191
"S01005276",607,717,110,0.153417015341702,0.189101665584346
"S01005277",611,698,87,0.124641833810888,0.264154416483347
"S01005278",784,914,130,0.142231947483589,0.215624780096916
"S01005279",524,570,46,0.0807017543859649,0.431086391316178
"S01005280",706,832,126,0.151442307692308,0.193559168424931
"S01005281",812,1010,198,0.196039603960396,0.112809728650428
"S01005282",698,809,111,0.137206427688504,0.228596201764884
"S01005283",761,890,129,0.144943820224719,0.208903877590706
"S01005284",781,955,174,0.182198952879581,0.13380631883782
"S01005285",677,723,46,0.0636237897648686,0.518207523483913
"S01005286",683,797,114,0.143036386449184,0.213611103152881
"S01005287",766,923,157,0.170097508125677,0.154978226267727
"S01005288",849,961,112,0.116545265348595,0.289629654206922
"S01005289",825,961,136,0.141519250780437,0.217423062567113
"S01005290",548,632,84,0.132911392405063,0.240234182254914
"S01005291",630,720,90,0.125,0.263075576163828
"S01005292",669,799,130,0.16270337922403,0.169353191149338
"S01005293",797,930,133,0.143010752688172,0.21367500776905
"S01005294",516,635,119,0.18740157480315,0.125533536360554
"S01005295",557,635,78,0.122834645669291,0.269658862879112
"S01005296",841,941,100,0.106269925611052,0.325135000702618
"S01005297",673,738,65,0.0880758807588076,0.397728785458526
"S01005298",1001,1145,144,0.125764192139738,0.260786981762278
"S01005299",548,614,66,0.107491856677524,0.320716920671933
"S01005300",886,1017,131,0.128810226155359,0.251841727456648
"S01005301",840,931,91,0.0977443609022556,0.3575164677055
"S01005302",967,1074,107,0.0996275605214153,0.350124036893828
"S01005303",719,801,82,0.102372034956305,0.339596920205955
"S01005304",696,782,86,0.10997442455243,0.311906816106104
"S01005305",763,890,127,0.142696629213483,0.214459511840881
"S01005306",974,1061,87,0.0819981149858624,0.425045800613577
"S01005307",864,992,128,0.129032258064516,0.251200617847236
"S01005308",497,561,64,0.114081996434938,0.29780725582802
"S01005309",856,1006,150,0.149105367793241,0.198956365891023
"S01005310",962,1076,114,0.105947955390335,0.326308214648025
"S01005311",891,1014,123,0.121301775147929,0.274408456130481
"S01005312",620,786,166,0.211195928753181,0.0932591460874898
"S01005313",865,978,113,0.115541922290389,0.292935851431433
"S01005314",505,590,85,0.144067796610169,0.211054037532666
"S01005315",639,838,199,0.237470167064439,0.0664612331774191
"S01005316",841,954,113,0.118448637316562,0.283449836579342
"S01005317",552,595,43,0.0722689075630252,0.472303452239744
"S01005318",516,597,81,0.135678391959799,0.23267713359299
"S01005319",650,729,79,0.108367626886145,0.317583757849331
"S01005320",626,735,109,0.148299319727891,0.200849123703297
"S01005321",608,703,95,0.135135135135135,0.234143735378922
"S01005322",728,978,250,0.255623721881391,0.0522306277118831
"S01005323",670,753,83,0.110225763612218,0.311027124318195
"S01005324",717,832,115,0.138221153846154,0.225921880218298
"S01005325",774,869,95,0.109321058688147,0.314204096064825
"S01005326",906,1033,127,0.122942884801549,0.269326297997537
"S01005327",592,727,135,0.185694635488308,0.128195552562801
"S01005328",605,806,201,0.249379652605459,0.056781038128419
"S01005329",490,604,114,0.188741721854305,0.123478519612927
"S01005330",646,742,96,0.129380053908356,0.250199321233726
"S01005331",677,797,120,0.150564617314931,0.195570557101139
"S01005332",516,587,71,0.120954003407155,0.275496447980414
"S01005333",770,867,97,0.111880046136102,0.305292599591188
"S01005334",493,697,204,0.292682926829268,0.0313430612801141
"S01005335",533,574,41,0.0714285714285714,0.47659904336004
"S01005336",527,645,118,0.182945736434109,0.132589461196624
"S01005337",907,1024,117,0.1142578125,0.297216765909872
"S01005338",548,617,69,0.111831442463533,0.305459716614539
"S01005339",707,820,113,0.13780487804878,0.227015554092409
"S01005340",545,618,73,0.118122977346278,0.284498690583594
"S01005341",656,748,92,0.122994652406417,0.269167372489763
"S01005342",754,818,64,0.078239608801956,0.442772278133859
"S01005343",896,1070,174,0.162616822429907,0.169528344015663
"S01005344",735,817,82,0.100367197062424,0.347258452472069
"S01005345",695,836,141,0.16866028708134,0.157683144318545
"S01005346",797,886,89,0.100451467268623,0.346933306377757
"S01005347",689,782,93,0.118925831202046,0.281919222160619
"S01005348",797,945,148,0.156613756613757,0.182081209198914
"S01005349",847,945,98,0.103703703703704,0.334592358496651
"S01005350",640,795,155,0.19496855345912,0.114321641916144
"S01005351",942,1128,186,0.164893617021277,0.164974959893962
"S01005352",882,944,62,0.0656779661016949,0.506950911596512
"S01005353",971,1088,117,0.107536764705882,0.320555583165175
"S01005354",938,1005,67,0.0666666666666667,0.501611825256015
"S01005355",786,900,114,0.126666666666667,0.258107346483966
"S01005356",704,765,61,0.0797385620915033,0.435624442741196
"S01005357",691,783,92,0.11749680715198,0.286525219010637
"S01005358",820,923,103,0.111592632719393,0.306282027669648
"S01005359",888,989,101,0.102123356926188,0.340538910166208
"S01005360",860,950,90,0.0947368421052632,0.369614039797739
"S01005361",859,957,98,0.102403343782654,0.33947848904363
"S01005362",739,809,70,0.0865265760197775,0.404537855439744
"S01005363",683,826,143,0.173123486682809,0.149419253937732
"S01005364",822,1038,216,0.208092485549133,0.0969939487256347
"S01005365",628,744,116,0.155913978494624,0.183597634723391
"S01005366",720,823,103,0.125151883353584,0.26261928354252
"S01005367",837,972,135,0.138888888888889,0.22417745303365
"S01005368",682,797,115,0.144291091593476,0.210504087190231
"S01005369",871,1088,217,0.199448529411765,0.108116653947534
"S01005370",791,928,137,0.147629310344828,0.202434753319329
"S01005371",935,1049,114,0.108674928503337,0.316490899591687
"S01005372",889,1080,191,0.176851851851852,0.142817048914774
"S01005373",763,895,132,0.147486033519553,0.202775287762616
"S01005374",848,1010,162,0.16039603960396,0.174078359282936
"S01005375",951,1049,98,0.0934223069590086,0.375016423298119
"S01005376",903,1011,108,0.106824925816024,0.323121567682561
"S01005377",823,955,132,0.138219895287958,0.225925179646033
"S01005378",683,863,180,0.208574739281576,0.0964048936040686
"S01005379",927,1048,121,0.115458015267176,0.293213873326142
"S01005380",625,737,112,0.151967435549525,0.192364662486518
"S01005381",634,728,94,0.129120879120879,0.250945137962771
"S01005382",689,832,143,0.171875,0.151690700248627
"S01005383",606,741,135,0.182186234817814,0.133827129230898
"S01005384",762,889,127,0.142857142857143,0.214058315601308
"S01005385",686,829,143,0.172496984318456,0.150555231697423
"S01005386",557,649,92,0.14175654853621,0.216822817590073
"S01005387",905,1022,117,0.114481409001957,0.296467324508079
"S01005388",693,815,122,0.149693251533742,0.197586040677271
"S01005389",684,864,180,0.208333333333333,0.0966993583693765
"S01005390",791,898,107,0.119153674832962,0.281191033715439
"S01005391",653,793,140,0.176544766708701,0.143350740127793
"S01005392",774,966,192,0.198757763975155,0.109053182137051
"S01005393",781,955,174,0.182198952879581,0.13380631883782
"S01005394",755,897,142,0.158305462653289,0.178461724719374
"S01005395",809,916,107,0.116812227074236,0.28875564251592
"S01005396",609,707,98,0.138613861386139,0.224894476107798
"S01005397",543,624,81,0.129807692307692,0.24897308409732
"S01005398",883,1043,160,0.153403643336529,0.189131536822466
"S01005399",896,1048,152,0.145038167938931,0.208673485480902
"S01005400",892,1096,204,0.186131386861314,0.127509634914805
"S01005401",859,1009,150,0.148662041625372,0.199995385801341
"S01005402",845,995,150,0.150753768844221,0.195135498423491
"S01005403",882,1006,124,0.123260437375746,0.268352746262431
"S01005404",721,999,278,0.278278278278278,0.0383440308089855
"S01005405",482,572,90,0.157342657342657,0.180513669406631
"S01005406",526,583,57,0.097770154373928,0.357414274887167
"S01005407",845,1037,192,0.185149469623915,0.129056393823715
"S01005408",500,629,129,0.205087440381558,0.100738061366221
"S01005409",587,675,88,0.13037037037037,0.247367866949496
"S01005410",699,886,187,0.211060948081264,0.0934188546960813
"S01005411",827,964,137,0.142116182572614,0.215915965443773
"S01005412",846,985,139,0.141116751269036,0.218444606083036
"S01005413",750,978,228,0.233128834355828,0.0703435182761473
"S01005414",860,1039,179,0.17228103946102,0.150948581727642
"S01005415",749,899,150,0.166852057842047,0.161146641858612
"S01005416",847,1054,207,0.196394686907021,0.112312474162044
"S01005417",700,809,109,0.134734239802225,0.23523134079608
"S01005418",731,852,121,0.142018779342723,0.216161239459563
"S01005419",662,739,77,0.104194857916103,0.332763367366722
"S01005420",809,882,73,0.0827664399092971,0.421501733235686
"S01005421",874,1030,156,0.151456310679612,0.193527229461463
"S01005422",749,1014,265,0.261341222879684,0.048354692631168
"S01005423",919,1039,120,0.115495668912416,0.293089080419952
"S01005424",743,896,153,0.170758928571429,0.153747492315484
"S01005425",737,1032,295,0.285852713178295,0.0345046721829352
"S01005426",715,862,147,0.170533642691415,0.154165700199003
"S01005427",687,866,179,0.206697459584296,0.0987162048244295
"S01005428",875,1071,196,0.183006535947712,0.132490830344031
"S01005429",597,754,157,0.208222811671088,0.0968344416170013
"S01005430",601,687,86,0.125181950509461,0.262529039376888
"S01005431",736,857,121,0.141190198366394,0.218257875818493
"S01005432",699,871,172,0.197474167623421,0.110812871107338
"S01005433",735,1012,277,0.273715415019763,0.0408383574212758
"S01005434",534,784,250,0.318877551020408,0.0214907683763422
"S01005435",731,856,125,0.146028037383178,0.206270025753223
"S01005436",768,979,211,0.215526046986721,0.0882643408493717
"S01005437",839,1001,162,0.161838161838162,0.171111356216068
"S01005438",802,904,102,0.11283185840708,0.302036464579151
"S01005439",581,696,115,0.165229885057471,0.164311866028874
"S01005440",861,1055,194,0.183886255924171,0.131071092148775
"S01005441",760,991,231,0.233097880928355,0.0703719163776512
"S01005442",673,930,257,0.276344086021505,0.0393841209681614
"S01005443",828,983,155,0.157680569684639,0.179791099999013
"S01005444",814,983,169,0.171922685656155,0.151603375309639
"S01005445",872,978,106,0.10838445807771,0.317523813199623
"S01005446",720,824,104,0.12621359223301,0.259449505534093
"S01005447",791,882,91,0.103174603174603,0.336572775154202
"S01005448",804,1011,207,0.204747774480712,0.101169343444168
"S01005449",812,1014,202,0.199211045364892,0.108437811101827
"S01005450",828,951,123,0.129337539432177,0.250321526461072
"S01005451",935,1064,129,0.121240601503759,0.274599555016344
"S01005452",873,1043,170,0.162991371045062,0.168771594229547
"S01005453",829,974,145,0.148870636550308,0.199505896824321
"S01005454",657,845,188,0.222485207100592,0.0807396023428915
"S01005455",775,1033,258,0.249757986447241,0.0564954939186235
"S01005456",782,934,152,0.162740899357602,0.169277317521821
"S01005457",850,1020,170,0.166666666666667,0.161505582889846
"S01005458",718,866,148,0.170900692840647,0.153484852878156
"S01005459",740,934,194,0.207708779443255,0.097464943419416
"S01005460",712,870,158,0.181609195402299,0.134774400963906
"S01005461",742,941,199,0.211477151965994,0.0929271929275297
"S01005462",866,1047,181,0.17287488061127,0.149869101418774
"S01005463",514,588,74,0.125850340136054,0.260530113809187
"S01005464",535,621,86,0.138486312399356,0.225227708587883
"S01005465",519,612,93,0.151960784313725,0.192379750443536
"S01005466",813,956,143,0.149581589958159,0.197845662406861
"S01005467",462,541,79,0.146025878003697,0.206275241619188
"S01005468",829,983,154,0.156663275686673,0.181974329215746
"S01005469",752,919,167,0.181719260065288,0.134593253709246
"S01005470",636,722,86,0.119113573407202,0.281319075025659
"S01005471",625,832,207,0.248798076923077,0.0572225108979918
"S01005472",729,876,147,0.167808219178082,0.159306766058942
"S01005473",627,798,171,0.214285714285714,0.089669860639415
"S01005474",774,923,149,0.161430119176598,0.171946205616506
"S01005475",679,956,277,0.289748953974895,0.0326677196626901
"S01005476",799,952,153,0.160714285714286,0.173419651561802
"S01005477",821,953,132,0.138509968520462,0.2251658714317
"S01005478",764,907,143,0.157662624035281,0.179829408237786
"S01005479",524,602,78,0.129568106312292,0.249659420010895
"S01005480",682,831,149,0.179302045728039,0.138622430358772
"S01005481",608,698,90,0.128939828080229,0.251467327614713
"S01005482",545,665,120,0.180451127819549,0.136693722241235
"S01005483",716,884,168,0.190045248868778,0.12150875553639
"S01005484",507,601,94,0.156405990016639,0.182530260373244
"S01005485",756,862,106,0.122969837587007,0.269243542951939
"S01005486",831,967,136,0.140641158221303,0.219657227171007
"S01005487",697,866,169,0.195150115473441,0.114064069189846
"S01005488",823,951,128,0.13459516298633,0.235609708927709
"S01005489",828,1009,181,0.179385530227948,0.138481482911422
"S01005490",583,626,43,0.0686900958466454,0.490842563358577
"S01005491",850,1002,152,0.151696606786427,0.192979884363605
"S01005492",875,1022,147,0.143835616438356,0.21162724206627
"S01005493",626,722,96,0.132963988919668,0.240088498963884
"S01005494",642,756,114,0.150793650793651,0.195043879063032
"S01005495",624,698,74,0.106017191977077,0.326055605243335
"S01005496",940,1020,80,0.0784313725490196,0.441851993134814
"S01005497",537,633,96,0.151658767772512,0.193065981324777
"S01005498",806,939,133,0.141640042598509,0.217117332888081
"S01005499",692,800,108,0.135,0.234509842310654
"S01005500",700,862,162,0.187935034802784,0.124711855804187
"S01005501",730,873,143,0.163802978235968,0.167142219205585
"S01005502",867,1041,174,0.167146974063401,0.16057712562467
"S01005503",558,639,81,0.126760563380282,0.257829975765703
"S01005504",589,725,136,0.187586206896552,0.12524860058785
"S01005505",605,713,108,0.151472650771388,0.19348996586832
"S01005506",739,974,235,0.241273100616016,0.0632200471148067
"S01005507",479,605,126,0.208264462809917,0.0967835142828091
"S01005508",685,843,158,0.187425860023725,0.125496024601221
"S01005509",550,640,90,0.140625,0.219698532039712
"S01005510",568,656,88,0.134146341463415,0.23683449805499
"S01005511",552,596,44,0.0738255033557047,0.464438463793296
"S01005512",622,685,63,0.091970802919708,0.381064184331846
"S01005513",680,794,114,0.143576826196474,0.212267792181861
"S01005514",531,593,62,0.104553119730185,0.331434930218229
"S01005515",566,618,52,0.0841423948220065,0.415221239927105
"S01005516",501,538,37,0.0687732342007435,0.490404562502221
"S01005517",869,1008,139,0.137896825396825,0.226773573322577
"S01005518",942,1043,101,0.0968360498561841,0.361131975540407
"S01005519",662,724,62,0.0856353591160221,0.408502042584763
"S01005520",910,1000,90,0.09,0.389416118118108
"S01005521",714,983,269,0.273652085452696,0.0408739810679839
"S01005522",592,657,65,0.0989345509893455,0.352828267060317
"S01005523",809,942,133,0.141188959660297,0.218261023885921
"S01005524",667,800,133,0.16625,0.162314930166807
"S01005525",720,821,101,0.123020706455542,0.269087419014981
"S01005526",654,784,130,0.165816326530612,0.163161187091327
"S01005527",489,571,82,0.143607705779334,0.212191268359914
"S01005528",526,632,106,0.167721518987342,0.15947281437225
"S01005529",816,911,95,0.104281009879254,0.332443478450548
"S01005530",622,703,81,0.115220483641536,0.294002211161324
"S01005531",505,642,137,0.213395638629283,0.0906908558797268
"S01005532",793,958,165,0.17223382045929,0.151034715689918
"S01005533",728,822,94,0.114355231143552,0.296890032823838
"S01005534",589,719,130,0.180806675938804,0.136101854869199
"S01005535",779,901,122,0.135405105438402,0.23341387411768
"S01005536",875,999,124,0.124124124124124,0.26572085914741
"S01005537",678,872,194,0.222477064220183,0.0807480585667165
"S01005538",831,955,124,0.129842931937173,0.248872277408243
"S01005539",825,979,154,0.157303370786517,0.180597846545836
"S01005540",730,855,125,0.146198830409357,0.205857860084172
"S01005541",622,730,108,0.147945205479452,0.201685764514238
"S01005542",751,825,74,0.0896969696969697,0.390714820007023
"S01005543",711,868,157,0.180875576036866,0.135987426657044
"S01005544",677,754,77,0.102122015915119,0.340543996271528
"S01005545",769,931,162,0.174006444683136,0.147831365416652
"S01005546",579,771,192,0.249027237354086,0.0570481882788368
"S01005547",617,764,147,0.192408376963351,0.118009794631288
"S01005548",902,1109,207,0.186654643823264,0.126692210568577
"S01005549",899,1048,149,0.142175572519084,0.215766536776275
"S01005550",586,670,84,0.125373134328358,0.26195586906805
"S01005551",848,975,127,0.13025641025641,0.247692219971047
"S01005552",777,897,120,0.133779264214047,0.237840471727759
"S01005553",769,882,113,0.1281179138322,0.253850221503834
"S01005554",682,768,86,0.111979166666667,0.304952042317238
"S01005555",638,801,163,0.203495630461923,0.102773613467974
"S01005556",477,574,97,0.168989547038328,0.157059737195359
"S01005557",745,865,120,0.138728323699422,0.224595811508378
"S01005558",697,789,92,0.11660329531052,0.28943946641254
"S01005559",640,748,108,0.144385026737968,0.210273121185716
"S01005560",588,723,135,0.186721991701245,0.12658734400915
"S01005561",800,925,125,0.135135135135135,0.234143735378922
"S01005562",846,977,131,0.134083930399181,0.237005264653567
"S01005563",738,823,85,0.103280680437424,0.336174885870702
"S01005564",729,844,115,0.136255924170616,0.231127071675539
"S01005565",540,634,94,0.148264984227129,0.200930108802945
"S01005566",506,601,95,0.158069883527454,0.178961844965926
"S01005567",917,1078,161,0.149350649350649,0.198383591412677
"S01005568",516,631,115,0.182250396196513,0.133722172544255
"S01005569",648,756,108,0.142857142857143,0.214058315601308
"S01005570",739,902,163,0.180709534368071,0.136263333299984
"S01005571",654,788,134,0.17005076142132,0.155065544453095
"S01005572",741,878,137,0.156036446469248,0.183331427782699
"S01005573",630,782,152,0.194373401534527,0.11516962796741
"S01005574",783,900,117,0.13,0.248423414191436
"S01005575",710,798,88,0.110275689223058,0.310852649734715
"S01005576",714,886,172,0.194130925507901,0.11551673327721
"S01005577",750,938,188,0.200426439232409,0.106803196325907
"S01005578",894,1023,129,0.126099706744868,0.259787859041075
"S01005579",738,887,149,0.167981961668546,0.158974482495502
"S01005580",544,734,190,0.258855585831063,0.0500067232503936
"S01005581",687,813,126,0.154981549815498,0.185635877232839
"S01005582",713,900,187,0.207777777777778,0.0973800972950781
"S01005583",528,648,120,0.185185185185185,0.128999838512784
"S01005584",534,629,95,0.151033386327504,0.194493958636197
"S01005585",699,929,230,0.247578040904198,0.0581586902490231
"S01005586",571,845,274,0.324260355029586,0.0198515303915123
"S01005587",931,1103,172,0.155938349954669,0.183544631107937
"S01005588",641,743,102,0.137281292059219,0.228397926875002
"S01005589",642,967,325,0.336091003102378,0.0166374031305608
"S01005590",692,880,188,0.213636363636364,0.0904136960080503
"S01005591",914,1061,147,0.138548539114043,0.225065080575728
"S01005592",476,623,147,0.235955056179775,0.0677936568253791
"S01005593",864,951,87,0.0914826498422713,0.383117734056654
"S01005594",708,925,217,0.234594594594595,0.0690105119983083
"S01005595",797,921,124,0.134636264929425,0.235497831260989
"S01005596",516,578,62,0.107266435986159,0.321527876350385
"S01005597",895,1061,166,0.156456173421301,0.182421706517685
"S01005598",810,1067,257,0.240862230552952,0.0635632353474174
"S01005599",531,638,107,0.167711598746081,0.159491823558313
"S01005600",747,962,215,0.223492723492724,0.0796994451191405
"S01005601",728,787,59,0.0749682337992376,0.458739851372344
"S01005602",692,794,102,0.128463476070529,0.25284590263978
"S01005603",451,601,150,0.249584026622296,0.0566266277007316
"S01005604",505,595,90,0.151260504201681,0.193974269006478
"S01005605",922,1055,133,0.1260663507109,0.259887034899743
"S01005606",571,677,106,0.156573116691285,0.182168966985492
"S01005607",566,680,114,0.167647058823529,0.159615544886738
"S01005608",846,979,133,0.13585291113381,0.232207751075772
"S01005609",702,845,143,0.169230769230769,0.156604425909251
"S01005610",545,629,84,0.133545310015898,0.238483627127223
"S01005611",664,793,129,0.162673392181589,0.169413853281919
"S01005612",696,851,155,0.18213866039953,0.13390500044097
"S01005613",753,852,99,0.116197183098592,0.290772823982617
"S01005614",739,840,101,0.120238095238095,0.277748372826062
"S01005615",887,1073,186,0.173345759552656,0.149018085201474
"S01005616",607,710,103,0.145070422535211,0.208594773938081
"S01005617",739,954,215,0.225366876310273,0.0777966035437427
"S01005618",579,657,78,0.118721461187215,0.282573832342943
"S01005619",564,668,104,0.155688622754491,0.18408839660845
"S01005620",475,579,104,0.179620034542314,0.138086257411441
"S01005621",677,798,121,0.151629072681704,0.193133572227761
"S01005622",869,978,109,0.111451942740286,0.306767407849936
"S01005623",745,892,147,0.164798206278027,0.165163540401058
"S01005624",849,938,89,0.0948827292110874,0.3690188224294
"S01005625",836,970,134,0.138144329896907,0.22612336085734
"S01005626",772,904,132,0.146017699115044,0.206294998364772
"S01005627",649,731,82,0.112175102599179,0.304279853457616
"S01005628",851,1016,165,0.16240157480315,0.169964617550451
"S01005629",724,829,105,0.126658624849216,0.258131114478322
"S01005630",484,582,98,0.168384879725086,0.158206298621167
"S01005631",718,788,70,0.0888324873096447,0.394441196504575
"S01005632",452,548,96,0.175182481751825,0.145739999356144
"S01005633",690,806,116,0.143920595533499,0.21141728400796
"S01005634",751,856,105,0.122663551401869,0.270185304135187
"S01005635",788,912,124,0.135964912280702,0.231906964654349
"S01005636",809,928,119,0.12823275862069,0.253516046721674
"S01005637",865,1103,238,0.215775158658205,0.0879844554064019
"S01005638",748,930,182,0.195698924731183,0.113288673876768
"S01005639",736,815,79,0.0969325153374233,0.360746441654691
"S01005640",467,582,115,0.197594501718213,0.110646825702805
"S01005641",844,978,134,0.137014314928425,0.229105712710442
"S01005642",742,899,157,0.174638487208009,0.146704060828214
"S01005643",583,689,106,0.153846153846154,0.188145280374965
"S01005644",588,659,71,0.107738998482549,0.319829938692702
"S01005645",825,977,152,0.155578300921187,0.18432907695012
"S01005646",658,929,271,0.291711517761033,0.0317761879948128
"S01005647",694,792,98,0.123737373737374,0.266896506167202
"S01005648",836,913,77,0.0843373493975904,0.414338222925127
"S01005649",818,1040,222,0.213461538461538,0.0906149058870027
"S01005650",577,675,98,0.145185185185185,0.208314932952114
"S01005651",659,851,192,0.225616921269095,0.0775458472040737
"S01005652",669,766,97,0.126631853785901,0.25821025189147
"S01005653",855,948,93,0.0981012658227848,0.356104755930931
"S01005654",700,837,137,0.163679808841099,0.167388578096101
"S01005655",792,973,181,0.186022610483042,0.127680158523098
"S01005656",557,644,87,0.135093167701863,0.234257378075954
"S01005657",566,646,80,0.123839009287926,0.266587100989253
"S01005658",852,952,100,0.105042016806723,0.329629797624009
"S01005659",856,915,59,0.0644808743169399,0.513483752231644
"S01005660",589,703,114,0.162162162162162,0.170451056590003
"S01005661",579,699,120,0.171673819742489,0.15205961263885
"S01005662",606,654,48,0.073394495412844,0.466604323309778
"S01005663",600,707,107,0.151343705799151,0.193784200657417
"S01005664",564,638,74,0.115987460815047,0.291463551581026
"S01005665",466,554,88,0.15884476534296,0.177321550295838
"S01005666",845,961,116,0.120707596253902,0.276269672468176
"S01005667",753,820,67,0.0817073170731707,0.42639415049153
"S01005668",823,943,120,0.127253446447508,0.256378395203199
"S01005669",547,651,104,0.159754224270353,0.175413646857516
"S01005670",631,751,120,0.159786950732357,0.175345337534724
"S01005671",468,566,98,0.173144876325088,0.149380606662967
"S01005672",796,916,120,0.131004366812227,0.245570356496612
"S01005673",572,698,126,0.180515759312321,0.136585960702997
"S01005674",876,1002,126,0.125748502994012,0.260833786701643
"S01005675",876,1016,140,0.137795275590551,0.227040838585151
"S01005676",824,929,105,0.11302475780409,0.301380380627647
"S01005677",766,898,132,0.146993318485523,0.203950291159735
"S01005678",789,918,129,0.140522875816993,0.219959751356556
"S01005679",741,929,188,0.202368137782562,0.104237728738137
"S01005680",698,812,114,0.140394088669951,0.220289569302069
"S01005681",814,944,130,0.13771186440678,0.227260577482636
"S01005682",582,710,128,0.180281690140845,0.136976592825572
"S01005683",848,952,104,0.109243697478992,0.314477109273473
"S01005684",858,986,128,0.129817444219067,0.248945184045902
"S01005685",611,734,123,0.167574931880109,0.159753912532334
"S01005686",693,817,124,0.151774785801714,0.192802109263723
"S01005687",497,585,88,0.15042735042735,0.195886824733959
"S01005688",764,857,93,0.108518086347725,0.317048254493482
"S01005689",459,516,57,0.11046511627907,0.310191461561473
"S01005690",707,805,98,0.121739130434783,0.273045695445479
"S01005691",636,726,90,0.12396694214876,0.26619809885281
"S01005692",612,710,98,0.138028169014085,0.226428314770962
"S01005693",812,945,133,0.140740740740741,0.219402821023923
"S01005694",564,643,79,0.122861586314152,0.269576053182626
"S01005695",520,618,98,0.158576051779935,0.177888832764858
"S01005696",644,747,103,0.137884872824632,0.226805016155668
"S01005697",596,682,86,0.126099706744868,0.259787859041075
"S01005698",549,614,65,0.10586319218241,0.326617712674242
"S01005699",713,864,151,0.174768518518519,0.146473100180845
"S01005700",499,630,131,0.207936507936508,0.0971851617229242
"S01005701",598,781,183,0.234314980793854,0.0692630323465648
"S01005702",643,710,67,0.0943661971830986,0.371130154190396
"S01005703",590,668,78,0.116766467065868,0.288905288403678
"S01005704",634,715,81,0.113286713286713,0.300491478673759
"S01005705",573,668,95,0.142215568862275,0.215665956031136
"S01005706",726,832,106,0.127403846153846,0.25593692285407
"S01005707",490,610,120,0.19672131147541,0.111856815275009
"S01005708",719,836,117,0.139952153110048,0.221424732884099
"S01005709",822,900,78,0.0866666666666667,0.403917882555998
"S01005710",561,624,63,0.100961538461538,0.344971101762164
"S01005711",809,925,116,0.125405405405405,0.261859231348595
"S01005712",529,601,72,0.119800332778702,0.279133525180657
"S01005713",618,702,84,0.11965811965812,0.279584846913011
"S01005714",746,918,172,0.187363834422658,0.1255918514344
"S01005715",750,853,103,0.120750293083236,0.276135550283004
"S01005716",582,625,43,0.0688,0.490263626127286
"S01005717",529,593,64,0.107925801011804,0.319160977635748
"S01005718",724,853,129,0.151230949589683,0.194041824866588
"S01005719",521,605,84,0.138842975206612,0.224297011150913
"S01005720",585,773,188,0.243208279430789,0.0616259633950764
"S01005721",747,831,84,0.101083032490975,0.344505198992808
"S01005722",522,561,39,0.0695187165775401,0.486492800318126
"S01005723",709,797,88,0.110414052697616,0.310369572387281
"S01005724",641,771,130,0.168612191958495,0.157774391791996
"S01005725",591,672,81,0.120535714285714,0.276810193089727
"S01005726",814,962,148,0.153846153846154,0.188145280374965
"S01005727",530,623,93,0.149277688603531,0.198553811996459
"S01005728",760,907,147,0.162072767364939,0.170633010126653
"S01005729",596,671,75,0.11177347242921,0.305659146237527
"S01005730",706,771,65,0.0843060959792477,0.414479666664844
"S01005731",502,616,114,0.185064935064935,0.129190342559627
"S01005732",888,998,110,0.110220440881764,0.3110457308146
"S01005733",823,1030,207,0.200970873786408,0.106078191041508
"S01005734",613,699,86,0.123032904148784,0.269049994638027
"S01005735",833,958,125,0.130480167014614,0.247055725610729
"S01005736",702,821,119,0.144945188794153,0.208900533981137
"S01005737",724,865,141,0.163005780346821,0.168742542050636
"S01005738",805,948,143,0.15084388185654,0.194928540147309
"S01005739",905,1077,172,0.159702878365831,0.175520868455905
"S01005740",662,808,146,0.180693069306931,0.136290720253918
"S01005741",889,1046,157,0.150095602294455,0.196653085265007
"S01005742",765,847,82,0.0968122786304604,0.361227036537123
"S01005743",554,687,133,0.193595342066958,0.116286761708915
"S01005744",841,908,67,0.0737885462555066,0.464623821750254
"S01005745",923,1011,88,0.0870425321463897,0.402258707975486
"S01005746",774,937,163,0.173959445037353,0.147915504101507
"S01005747",856,935,79,0.0844919786096257,0.413639055741996
"S01005748",519,582,63,0.108247422680412,0.318012163906413
"S01005749",817,891,74,0.0830527497194164,0.420187883482119
"S01005750",800,891,91,0.102132435465769,0.340504479430821
"S01005751",778,850,72,0.0847058823529412,0.412673624840778
"S01005752",769,863,94,0.108922363847045,0.315613405152486
"S01005753",702,785,83,0.105732484076433,0.32709548829889
"S01005754",882,1096,214,0.195255474452555,0.113914841398469
"S01005755",766,914,148,0.161925601750547,0.170932930770116
"S01005756",836,932,96,0.103004291845494,0.337212489055593
"S01005757",610,662,52,0.0785498489425982,0.441284278971999
"S01005758",816,914,98,0.107221006564551,0.321691532914903
"S01005759",838,924,86,0.0930735930735931,0.376461418311993
"S01005760",593,680,87,0.127941176470588,0.254365265524909
"S01005761",665,789,124,0.157160963244613,0.180903271548319
"S01005762",740,823,83,0.100850546780073,0.345397225924483
"S01005763",717,839,122,0.145411203814064,0.207764789536469
"S01005764",565,653,88,0.134762633996937,0.235154159673611
"S01005765",810,942,132,0.140127388535032,0.220973991679308
"S01005766",599,689,90,0.130624092888244,0.246647095052408
"S01005767",685,791,106,0.134007585335019,0.237214307577465
"S01005768",829,957,128,0.133751306165099,0.237917248017569
"S01005769",747,830,83,0.1,0.3486784401
"S01005770",546,664,118,0.177710843373494,0.141333669014956
"S01005771",788,855,67,0.0783625730994152,0.442181967349976
"S01005772",737,828,91,0.109903381642512,0.31215587331831
"S01005773",760,907,147,0.162072767364939,0.170633010126653
"S01005774",684,772,88,0.113989637305699,0.298117872905405
"S01005775",800,897,97,0.108138238573021,0.318401745188048
"S01005776",671,758,87,0.114775725593668,0.295483439293368
"S01005777",571,656,85,0.129573170731707,0.249644894498684
"S01005778",661,725,64,0.0882758620689655,0.396857442362673
"S01005779",662,763,101,0.132372214941022,0.24173220572129
"S01005780",595,699,104,0.148783977110157,0.199709120842489
"S01005781",804,924,120,0.12987012987013,0.248794499961089
"S01005782",750,840,90,0.107142857142857,0.321973236590696
"S01005783",547,611,64,0.104746317512275,0.330720534295967
"S01005784",476,538,62,0.115241635687732,0.293931932868601
"S01005785",799,860,61,0.0709302325581395,0.479163005926836
"S01005786",694,773,79,0.102199223803364,0.340251278200653
"S01005787",720,816,96,0.117647058823529,0.286037765539156
"S01005788",502,561,59,0.105169340463458,0.329161140849126
"S01005789",884,997,113,0.113340020060181,0.300310880291596
"S01005790",591,700,109,0.155714285714286,0.18403245034116
"S01005791",467,548,81,0.147810218978102,0.202005512410743
"S01005792",873,994,121,0.121730382293763,0.273072894076334
"S01005793",529,598,69,0.115384615384615,0.293457275025112
"S01005794",937,1030,93,0.0902912621359223,0.388171514305973
"S01005795",688,783,95,0.121328224776501,0.274325867836926
"S01005796",503,643,140,0.217729393468118,0.0858163662899189
"S01005797",645,818,173,0.211491442542787,0.0929103528969297
"S01005798",634,696,62,0.0890804597701149,0.393369046167164
"S01005799",726,856,130,0.151869158878505,0.192587706050398
"S01005800",657,752,95,0.126329787234043,0.259104699277592
"S01005801",741,850,109,0.128235294117647,0.253508673414651
"S01005802",631,716,85,0.118715083798883,0.282594281516124
"S01005803",634,734,100,0.136239782016349,0.231170269686721
"S01005804",595,675,80,0.118518518518519,0.283225224017918
"S01005805",585,653,68,0.104134762633997,0.332986669795946
"S01005806",649,742,93,0.12533692722372,0.262064331670821
"S01005807",890,1015,125,0.123152709359606,0.268682662923904
"S01005808",775,856,81,0.0946261682242991,0.370066163935229
"S01005809",554,633,79,0.12480252764613,0.263669895525674
"S01005810",469,563,94,0.16696269982238,0.160932767089231
"S01005811",585,658,73,0.110942249240122,0.308531652089235
"S01005812",688,778,90,0.115681233933162,0.292474772921911
"S01005813",833,920,87,0.0945652173913043,0.370315372323809
"S01005814",689,756,67,0.0886243386243386,0.395343191659757
"S01005815",924,1013,89,0.087857847976308,0.398680742666934
"S01005816",745,850,105,0.123529411764706,0.267530604178028
"S01005817",508,588,80,0.136054421768707,0.231666833208187
"S01005818",777,893,116,0.12989921612542,0.24871134671989
"S01005819",700,758,58,0.0765171503957784,0.451116117449514
"S01005820",628,794,166,0.209068010075567,0.095805714277904
"S01005821",502,565,63,0.111504424778761,0.306586264013676
"S01005822",826,960,134,0.139583333333333,0.222376117122987
"S01005823",668,735,67,0.091156462585034,0.384495475720674
"S01005824",734,781,47,0.060179257362356,0.537588859710983
"S01005825",686,760,74,0.0973684210526316,0.359008915857383
"S01005826",948,1046,98,0.0936902485659656,0.373909524588407
"S01005827",722,866,144,0.166281755196305,0.162253119562364
"S01005828",733,852,119,0.139671361502347,0.222148711572297
"S01005829",736,843,107,0.126927639383155,0.257337096834008
"S01005830",854,990,136,0.137373737373737,0.228153303227083
"S01005831",904,1000,96,0.096,0.364488898094601
"S01005832",755,860,105,0.122093023255814,0.271947458130006
"S01005833",690,786,96,0.122137404580153,0.271810010275569
"S01005834",672,762,90,0.118110236220472,0.284539796873838
"S01005835",672,776,104,0.134020618556701,0.237178609143747
"S01005836",697,762,65,0.0853018372703412,0.409994534745675
"S01005837",472,561,89,0.158645276292335,0.177742536599033
"S01005838",709,785,76,0.0968152866242038,0.36121500634278
"S01005839",841,938,97,0.103411513859275,0.335684720849218
"S01005840",761,860,99,0.115116279069767,0.294348654720314
"S01005841",639,764,125,0.163612565445026,0.167523213729489
"S01005842",568,677,109,0.161004431314623,0.172821062268639
"S01005843",542,622,80,0.128617363344051,0.252399806994778
"S01005844",737,798,61,0.0764411027568922,0.45148774353081
"S01005845",515,590,75,0.127118644067797,0.256774666595848
"S01005846",815,994,179,0.180080482897384,0.137313185833737
"S01005847",726,839,113,0.134684147794994,0.23536755652001
"S01005848",577,667,90,0.134932533733133,0.234692814077125
"S01005849",790,893,103,0.115341545352744,0.293600184406536
"S01005850",679,778,99,0.127249357326478,0.256390407675631
"S01005851",687,828,141,0.170289855072464,0.154619406795432
"S01005852",529,613,84,0.137030995106036,0.229061433973562
"S01005853",898,1079,181,0.167747914735867,0.159422244716839
"S01005854",836,884,48,0.0542986425339367,0.572189816553783
"S01005855",876,1047,171,0.163323782234957,0.16810252811292
"S01005856",744,825,81,0.0981818181818182,0.35578683163543
"S01005857",641,766,125,0.163185378590078,0.168380811740621
"S01005858",747,843,96,0.113879003558719,0.298490333968047
"S01005859",713,817,104,0.127294981640147,0.25625640737367
"S01005860",727,833,106,0.127250900360144,0.256385874698354
"S01005861",499,644,145,0.225155279503106,0.0780093721666232
"S01005862",778,889,111,0.124859392575928,0.263498629183179
"S01005863",862,1003,141,0.140578265204387,0.219818038413978
"S01005864",840,985,145,0.147208121827411,0.203437287048237
"S01005865",710,793,83,0.104665825977301,0.331018002788538
"S01005866",743,822,79,0.0961070559610706,0.364057483036268
"S01005867",866,1003,137,0.136590229312064,0.23023406951948
"S01005868",740,830,90,0.108433734939759,0.317348371143541
"S01005869",752,846,94,0.111111111111111,0.307946147657439
"S01005870",718,810,92,0.11358024691358,0.299498225540844
"S01005871",698,796,98,0.123115577889447,0.268796462484382
"S01005872",771,839,68,0.0810488676996424,0.429461436290308
"S01005873",970,1109,139,0.125338142470694,0.26206069060142
"S01005874",814,975,161,0.165128205128205,0.164512117322757
"S01005875",562,778,216,0.277634961439589,0.0386871899476365
"S01005876",832,936,104,0.111111111111111,0.307946147657439
"S01005877",857,938,81,0.0863539445628998,0.405303015955287
"S01005878",633,731,98,0.13406292749658,0.237062756851905
"S01005879",644,711,67,0.0942334739803094,0.371674414795887
"S01005880",725,852,127,0.14906103286385,0.199060054227497
"S01005881",718,867,149,0.171856978085352,0.15172371488514
"S01005882",534,634,100,0.157728706624606,0.179688379252648
"S01005883",468,540,72,0.133333333333333,0.2390677160551
"S01005884",786,872,86,0.0986238532110092,0.354046749158493
"S01005885",637,707,70,0.099009900990099,0.352533331679505
"S01005886",762,851,89,0.104582843713279,0.331324928217822
"S01005887",485,570,85,0.149122807017544,0.198915593219786
"S01005888",587,664,77,0.115963855421687,0.291541389148523
"S01005889",738,876,138,0.157534246575342,0.180103667493072
"S01005890",740,863,123,0.14252607184241,0.21488655337159
"S01005891",586,681,95,0.139500734214391,0.222589688163787
"S01005892",696,812,116,0.142857142857143,0.214058315601308
"S01005893",729,830,101,0.121686746987952,0.273208595954043
"S01005894",594,681,87,0.127753303964758,0.254913790394557
"S01005895",612,695,83,0.119424460431655,0.280327804416313
"S01005896",631,690,59,0.0855072463768116,0.409074760759207
"S01005897",756,831,75,0.0902527075812274,0.388336057459007
"S01005898",675,800,125,0.15625,0.182868060334095
"S01005899",664,759,95,0.125164690382082,0.262580840857135
"S01005900",698,765,67,0.0875816993464052,0.399889383790761
"S01005901",704,824,120,0.145631067961165,0.207230881541395
"S01005902",830,941,111,0.117959617428268,0.285026138766931
"S01005903",852,959,107,0.111574556830031,0.306344350734223
"S01005904",710,837,127,0.151732377538829,0.192898525194342
"S01005905",670,784,114,0.145408163265306,0.207772181735968
"S01005906",908,992,84,0.0846774193548387,0.412801972354438
"S01005907",677,829,152,0.18335343787696,0.131929337430239
"S01005908",726,898,172,0.191536748329621,0.119289670869115
"S01005909",522,590,68,0.115254237288136,0.293890070869673
"S01005910",730,853,123,0.144196951934349,0.210735785098496
"S01005911",936,1062,126,0.11864406779661,0.282822085199835
"S01005912",806,919,113,0.122959738846572,0.269274547148419
"S01005913",892,990,98,0.098989898989899,0.352611601976292
"S01005914",698,861,163,0.18931475029036,0.122609102017979
"S01005915",688,783,95,0.121328224776501,0.274325867836926
"S01005916",689,817,128,0.156670746634027,0.181958209125174
"S01005917",825,999,174,0.174174174174174,0.147531447411233
"S01005918",885,984,99,0.100609756097561,0.34632330924373
"S01005919",492,616,124,0.201298701298701,0.105643773648744
"S01005920",848,961,113,0.117585848074922,0.286236258134264
"S01005921",566,671,105,0.156482861400894,0.182364000284065
"S01005922",852,1042,190,0.182341650671785,0.133573023945917
"S01005923",714,838,124,0.147971360381862,0.201623863062368
"S01005924",624,724,100,0.138121546961326,0.226183143104178
"S01005925",719,833,114,0.136854741896759,0.229529700374558
"S01005926",705,785,80,0.101910828025478,0.341345830577369
"S01005927",780,914,134,0.146608315098468,0.204872689886166
"S01005928",744,853,109,0.12778429073857,0.254823246132657
"S01005929",582,658,76,0.115501519756839,0.293069693657132
"S01005930",484,699,215,0.30758226037196,0.0253327221029078
"S01005931",736,848,112,0.132075471698113,0.242560243990708
"S01005932",657,739,82,0.110960757780785,0.30846742751342
"S01005933",724,903,179,0.198228128460687,0.109776191309097
"S01005934",688,779,91,0.116816431322208,0.288741897145383
"S01005935",587,727,140,0.192572214580468,0.117770604405959
"S01005936",852,915,63,0.0688524590163934,0.489987506832817
"S01005937",597,685,88,0.128467153284672,0.252835234688975
"S01005938",633,746,113,0.151474530831099,0.193485678804825
"S01005939",717,815,98,0.120245398773006,0.277725315801812
"S01005940",552,691,139,0.201157742402315,0.105830367333473
"S01005941",481,551,70,0.127041742286751,0.257000977531013
"S01005942",779,897,118,0.131549609810479,0.244033891954866
"S01005943",871,992,121,0.121975806451613,0.272310776479944
"S01005944",881,1067,186,0.174320524835989,0.147270204497545
"S01005945",789,965,176,0.182383419689119,0.133504805580621
"S01005946",937,1082,145,0.134011090573013,0.23720470613703
"S01005947",761,863,102,0.11819235225956,0.284274962263613
"S01005948",653,759,106,0.13965744400527,0.222184651084056
"S01005949",663,762,99,0.12992125984252,0.248648343701506
"S01005950",483,612,129,0.21078431372549,0.0937469368188644
"S01005951",785,914,129,0.141137855579869,0.218390936237325
"S01005952",791,1059,268,0.253068932955618,0.0540511867650638
"S01005953",864,1002,138,0.137724550898204,0.227227143780226
"S01005954",640,718,78,0.108635097493036,0.316632359626867
"S01005955",433,576,143,0.248263888888889,0.0576307311333698
"S01005956",804,915,111,0.121311475409836,0.274378164710851
"S01005957",943,1017,74,0.0727630285152409,0.469793926749696
"S01005958",578,625,47,0.0752,0.457591776213137
"S01005959",489,578,89,0.153979238754325,0.187849570760818
"S01005960",480,546,66,0.120879120879121,0.275731222731346
"S01005961",745,888,143,0.161036036036036,0.172755972106704
"S01005962",498,554,56,0.101083032490975,0.344505198992808
"S01005963",511,584,73,0.125,0.263075576163828
"S01005964",713,795,82,0.10314465408805,0.336685189032413
"S01005965",748,856,108,0.126168224299065,0.259584245997733
"S01005966",897,1034,137,0.132495164410058,0.241389871122318
"S01005967",887,1014,127,0.125246548323471,0.262335248588077
"S01005968",752,866,114,0.131639722863741,0.243780793170844
"S01005969",711,808,97,0.120049504950495,0.278344343198885
"S01005970",737,876,139,0.158675799086758,0.17767806541744
"S01005971",478,546,68,0.124542124542125,0.264455460667413
"S01005972",747,843,96,0.113879003558719,0.298490333968047
"S01005973",684,814,130,0.15970515970516,0.175516103263238
"S01005974",741,844,103,0.122037914691943,0.272118215036503
"S01005975",735,794,59,0.0743073047858942,0.462028075464553
"S01005976",724,873,149,0.170675830469645,0.153901631902453
"S01005977",723,836,113,0.135167464114833,0.234056226275459
"S01005978",679,775,96,0.123870967741935,0.266489877837257
"S01005979",906,1026,120,0.116959064327485,0.288275921457405
"S01005980",641,740,99,0.133783783783784,0.237828062519394
"S01005981",679,817,138,0.16891064871481,0.157208917576034
"S01005982",702,851,149,0.175088131609871,0.145906795885224
"S01005983",941,1060,119,0.112264150943396,0.303974800164567
"S01005984",625,753,128,0.169986719787517,0.155185239722756
"S01005985",796,865,69,0.0797687861271676,0.435481392272806
"S01005986",731,832,101,0.121394230769231,0.274119863364979
"S01005987",555,649,94,0.144838212634823,0.209162037246237
"S01005988",673,787,114,0.144853875476493,0.209123731022558
"S01005989",778,868,90,0.1036866359447,0.334656078843921
"S01005990",895,1082,187,0.172828096118299,0.149953893123124
"S01005991",764,908,144,0.158590308370044,0.177858694630296
"S01005992",702,841,139,0.165279429250892,0.164214371822178
"S01005993",761,854,93,0.108899297423888,0.315695114311755
"S01005994",909,1002,93,0.092814371257485,0.377538822442585
"S01005995",623,727,104,0.143053645116919,0.213568087219601
"S01005996",614,797,183,0.22961104140527,0.0736377478424163
"S01005997",638,716,78,0.108938547486034,0.315556088530774
"S01005998",610,754,144,0.190981432360743,0.120111583181515
"S01005999",833,916,83,0.0906113537117904,0.386807848379314
"S01006000",839,963,124,0.128764278296989,0.251974584098472
"S01006001",855,969,114,0.117647058823529,0.286037765539156
"S01006002",527,601,74,0.123128119800333,0.268758019512636
"S01006003",633,695,62,0.0892086330935252,0.392815896268183
"S01006004",463,653,190,0.290964777947933,0.0321127943009843
"S01006005",793,936,143,0.152777777777778,0.190534395210396
"S01006006",765,874,109,0.124713958810069,0.263936847546773
"S01006007",510,584,74,0.126712328767123,0.257972427197663
"S01006008",733,845,112,0.132544378698225,0.241252963547151
"S01006009",554,613,59,0.0962479608482871,0.363490363786089
"S01006010",866,973,107,0.109969167523124,0.311925239698657
"S01006011",761,916,155,0.169213973799127,0.156636089073129
"S01006012",802,945,143,0.151322751322751,0.193832053924986
"S01006013",527,571,44,0.0770577933450088,0.448482054231099
"S01006014",629,765,136,0.177777777777778,0.141218665425476
"S01006015",686,789,103,0.130544993662864,0.246871596142285
"S01006016",894,1032,138,0.133720930232558,0.238000689399111
"S01006017",595,768,173,0.225260416666667,0.0779035873842214
"S01006018",759,893,134,0.150055991041433,0.196744758035171
"S01006019",703,863,160,0.18539976825029,0.12866051724919
"S01006020",791,888,97,0.109234234234234,0.314510520388549
"S01006021",854,931,77,0.0827067669172932,0.421776032339916
"S01006022",501,606,105,0.173267326732673,0.149159533700767
"S01006023",758,813,55,0.0676506765067651,0.496348370432028
"S01006024",791,916,125,0.13646288209607,0.230573874980188
"S01006025",803,905,102,0.112707182320442,0.302461192943277
"S01006026",736,831,95,0.114320096269555,0.297007834640708
"S01006027",716,821,105,0.1278928136419,0.254506367179412
"S01006028",553,718,165,0.229805013927577,0.0734525488402651
"S01006029",723,793,70,0.0882723833543506,0.396872584854043
"S01006030",887,1024,137,0.1337890625,0.237813569689546
"S01006031",825,921,96,0.104234527687296,0.332616036036041
"S01006032",852,1018,166,0.163064833005894,0.168623526500937
"S01006033",668,758,90,0.118733509234828,0.282535203766371
"S01006034",696,812,116,0.142857142857143,0.214058315601308
"S01006035",922,1048,126,0.120229007633588,0.277777064505951
"S01006036",491,834,343,0.411270983213429,0.00500212355534997
"S01006037",826,971,145,0.149330587023687,0.198430384593729
"S01006038",664,742,78,0.105121293800539,0.3293379219643
"S01006039",804,864,60,0.0694444444444444,0.48688126422577
"S01006040",741,843,102,0.120996441281139,0.275363474916768
"S01006041",849,977,128,0.131013306038895,0.245545096214736
"S01006042",793,880,87,0.0988636363636364,0.353106044302335
"S01006043",583,655,72,0.109923664122137,0.312084750185902
"S01006044",864,1072,208,0.194029850746269,0.115661699981455
"S01006045",625,681,56,0.0822320117474303,0.423964071600801
"S01006046",756,891,135,0.151515151515152,0.193393073125955
"S01006047",711,791,80,0.101137800252844,0.344295361963712
"S01006048",764,867,103,0.118800461361015,0.282320627732134
"S01006049",712,820,108,0.131707317073171,0.243591097723488
"S01006050",802,928,126,0.135775862068966,0.232414875193305
"S01006051",855,1048,193,0.184160305343511,0.130631622440082
"S01006052",700,826,126,0.152542372881356,0.191064466913606
"S01006053",837,914,77,0.0842450765864333,0.414755947667486
"S01006054",653,785,132,0.168152866242038,0.158648235170266
"S01006055",563,645,82,0.127131782945736,0.256736018703236
"S01006056",930,1003,73,0.0727816550348953,0.469699562147202
"S01006057",485,596,111,0.186241610738255,0.127337051236354
"S01006058",784,860,76,0.0883720930232558,0.396438764882073
"S01006059",759,883,124,0.140430351075878,0.22019665796414
"S01006060",582,676,94,0.13905325443787,0.223749919161805
"S01006061",597,747,150,0.200803212851406,0.106300986068044
"S01006062",633,743,110,0.148048452220727,0.201441507371142
"S01006063",559,669,110,0.164424514200299,0.16590401682846
"S01006064",695,823,128,0.155528554070474,0.184437698299229
"S01006065",658,864,206,0.238425925925926,0.065632887501908
"S01006066",694,895,201,0.224581005586592,0.0785894684523239
"S01006067",937,1111,174,0.156615661566157,0.182077096581312
"S01006068",468,524,56,0.106870229007634,0.322957712935692
"S01006069",789,906,117,0.129139072847682,0.250892717391647
"S01006070",601,689,88,0.127721335268505,0.25500723420761
"S01006071",921,1016,95,0.093503937007874,0.374678887880222
"S01006072",573,694,121,0.174351585014409,0.147214814183058
"S01006073",472,540,68,0.125925925925926,0.260304926810834
"S01006074",664,747,83,0.111111111111111,0.307946147657439
"S01006075",894,1038,144,0.138728323699422,0.224595811508378
"S01006076",912,1039,127,0.12223291626564,0.271514425004211
"S01006077",716,856,140,0.163551401869159,0.167645760899105
"S01006078",934,1070,136,0.127102803738318,0.256821267745728
"S01006079",734,849,115,0.13545347467609,0.233283325008682
"S01006080",937,1025,88,0.0858536585365854,0.407527814030529
"S01006081",717,840,123,0.146428571428571,0.205304607513347
"S01006082",913,1021,108,0.105778648383937,0.326926672713622
"S01006083",865,989,124,0.125379170879676,0.261937789804803
"S01006084",712,866,154,0.177829099307159,0.141130544205615
"S01006085",742,868,126,0.145161290322581,0.208373171096792
"S01006086",670,752,82,0.109042553191489,0.315187961276271
"S01006087",702,788,86,0.109137055837563,0.314853805214047
"S01006088",769,863,94,0.108922363847045,0.315613405152486
"S01006089",687,824,137,0.16626213592233,0.162291305430813
"S01006090",829,949,120,0.126448893572181,0.258751681791515
"S01006091",541,683,142,0.207906295754026,0.0972222380419958
"S01006092",592,688,96,0.13953488372093,0.222501367685551
"S01006093",570,635,65,0.102362204724409,0.339634112462959
"S01006094",907,993,86,0.0866062437059416,0.404185180162383
"S01006095",860,1029,169,0.164237123420797,0.166276458063004
"S01006096",696,788,92,0.116751269035533,0.288955004941601
"S01006097",872,1004,132,0.131474103585657,0.24424614689683
"S01006098",629,753,124,0.164674634794157,0.165408069301662
"S01006099",541,645,104,0.161240310077519,0.172335800069816
"S01006100",768,985,217,0.220304568527919,0.0830328405434164
"S01006101",600,689,89,0.129172714078374,0.250795814746782
"S01006102",731,850,119,0.14,0.221301578888031
"S01006103",619,792,173,0.218434343434343,0.0850461531770083
"S01006104",718,818,100,0.122249388753056,0.271463475950036
"S01006105",629,795,166,0.208805031446541,0.0961247377345819
"S01006106",547,676,129,0.190828402366864,0.1203389738628
"S01006107",659,743,84,0.113055181695828,0.30127702093422
"S01006108",913,992,79,0.0796370967741935,0.436104987806434
"S01006109",691,843,152,0.180308422301305,0.136931929397843
"S01006110",749,848,99,0.116745283018868,0.288974588804753
"S01006111",763,851,88,0.103407755581669,0.335698792189485
"S01006112",660,808,148,0.183168316831683,0.132228705925162
"S01006113",842,924,82,0.0887445887445888,0.394821871510869
"S01006114",667,759,92,0.121212121212121,0.274688564773928
"S01006115",755,988,233,0.23582995951417,0.0679047368304502
"S01006116",870,1024,154,0.150390625,0.19597151939715
"S01006117",759,891,132,0.148148148148148,0.201205903295558
"S01006118",442,575,133,0.231304347826087,0.0720351137989786
"S01006119",910,1121,211,0.188224799286351,0.124267567507104
"S01006120",558,1089,531,0.487603305785124,0.00124756502741033
"S01006121",458,662,204,0.308157099697885,0.0251231959484348
"S01006122",774,956,182,0.190376569037657,0.121012625649668
"S01006123",465,753,288,0.382470119521912,0.00806454309262301
"S01006124",468,774,306,0.395348837209302,0.00653204132909489
"S01006125",449,646,197,0.304953560371517,0.0263110530400542
"S01006126",468,863,395,0.457705677867903,0.00219963475763411
"S01006127",445,749,304,0.405874499332443,0.0054800173415555
"S01006128",479,1045,566,0.541626794258373,0.00040944184890126
"S01006129",662,747,85,0.113788487282463,0.298795378724834
"S01006130",727,853,126,0.147713950762016,0.20223382539198
"S01006131",863,987,124,0.125633232016211,0.261177902913061
"S01006132",750,910,160,0.175824175824176,0.144610128059448
"S01006133",540,614,74,0.120521172638436,0.276855966133318
"S01006134",467,530,63,0.118867924528302,0.282104562214929
"S01006135",513,611,98,0.160392798690671,0.17408507891141
"S01006136",866,1096,230,0.20985401459854,0.0948578722265505
"S01006137",478,836,358,0.42822966507177,0.00373436007925175
"S01006138",583,702,119,0.16951566951567,0.156068201721017
"S01006139",631,751,120,0.159786950732357,0.175345337534724
"S01006140",722,931,209,0.224489795918367,0.0786819592837673
"S01006141",673,932,259,0.277896995708155,0.0385470829765176
"S01006142",622,701,79,0.112696148359486,0.302498807715883
"S01006143",493,593,100,0.168634064080944,0.157732889471673
"S01006144",934,1066,132,0.123827392120075,0.26662245033628
"S01006145",833,1017,184,0.180924287118977,0.135906580302474
"S01006146",712,926,214,0.23110151187905,0.0722254189270014
"S01006147",690,924,234,0.253246753246753,0.053922646020384
"S01006148",714,858,144,0.167832167832168,0.159260927002452
"S01006149",914,1115,201,0.180269058295964,0.136997702358472
"S01006150",885,1068,183,0.171348314606742,0.152658215031814
"S01006151",545,2609,2064,0.791107704101188,1.58206466854273e-07
"S01006152",644,761,117,0.153745072273325,0.188370159665246
"S01006153",526,649,123,0.189522342064715,0.122295499030089
"S01006154",688,830,142,0.171084337349398,0.153145224417972
"S01006155",810,926,116,0.125269978401728,0.262264991139035
"S01006156",546,611,65,0.106382978723404,0.324723952575836
"S01006157",699,824,125,0.151699029126214,0.192974373872325
"S01006158",762,968,206,0.212809917355372,0.0913684253495948
"S01006159",684,901,217,0.240843507214206,0.0635789142944033
"S01006160",675,836,161,0.192583732057416,0.117753806208264
"S01006161",690,818,128,0.156479217603912,0.182371878135987
"S01006162",628,695,67,0.0964028776978417,0.362867766402611
"S01006163",886,1064,178,0.167293233082707,0.16029535559945
"S01006164",614,702,88,0.125356125356125,0.262006816394469
"S01006165",712,899,187,0.208008898776418,0.0970963756245287
"S01006166",795,1009,214,0.21209117938553,0.0922060938309254
"S01006167",711,965,254,0.263212435233161,0.0471436141792821
"S01006168",692,820,128,0.15609756097561,0.183198714002035
"S01006169",612,735,123,0.16734693877551,0.16019200258994
"S01006170",885,1048,163,0.155534351145038,0.184425037527023
"S01006171",833,994,161,0.161971830985915,0.170838665422191
"S01006172",490,563,73,0.129662522202487,0.249388746175188
"S01006173",542,710,168,0.236619718309859,0.0672062059038626
"S01006174",513,644,131,0.203416149068323,0.102876215027697
"S01006175",693,827,134,0.162031438935913,0.170717188792409
"S01006176",480,608,128,0.210526315789474,0.0940538507296812
"S01006177",617,719,102,0.141863699582754,0.216552267975738
"S01006178",825,902,77,0.0853658536585366,0.409707684876381
"S01006179",752,830,78,0.0939759036144578,0.372732688747375
"S01006180",738,901,163,0.180910099889012,0.135930122548607
"S01006181",822,939,117,0.124600638977636,0.264278755323315
"S01006182",480,639,159,0.248826291079812,0.0572010225072101
"S01006183",684,776,92,0.118556701030928,0.283102565253649
"S01006184",765,831,66,0.0794223826714801,0.437123458398122
"S01006185",940,1030,90,0.087378640776699,0.40078022886942
"S01006186",799,907,108,0.119073869900772,0.281445897497471
"S01006187",846,963,117,0.121495327102804,0.273804611983202
"S01006188",686,829,143,0.172496984318456,0.150555231697423
"S01006189",723,846,123,0.145390070921986,0.20781617283938
"S01006190",784,866,82,0.0946882217090069,0.369812602225416
"S01006191",550,638,88,0.137931034482759,0.226683603446804
"S01006192",750,896,146,0.162946428571429,0.168862236615333
"S01006193",619,738,119,0.161246612466125,0.172322851301873
"S01006194",937,1073,136,0.126747437092265,0.257868734659487
"S01006195",716,809,93,0.11495673671199,0.294879788890224
"S01006196",780,972,192,0.197530864197531,0.110734609288001
"S01006197",799,897,98,0.109253065774805,0.314444036533496
"S01006198",858,1001,143,0.142857142857143,0.214058315601308
"S01006199",677,785,108,0.137579617834395,0.227609360931813
"S01006200",802,953,151,0.158447009443862,0.178161834728947
"S01006201",949,1061,112,0.105560791705938,0.327724028905632
"S01006202",690,828,138,0.166666666666667,0.161505582889846
"S01006203",589,638,49,0.0768025078369906,0.449724099292282
"S01006204",908,990,82,0.0828282828282828,0.42121762904159
"S01006205",682,743,61,0.0820995962314939,0.424576164036936
"S01006206",794,894,100,0.111856823266219,0.305372437957387
"S01006207",858,968,110,0.113636363636364,0.299308675706572
"S01006208",700,769,69,0.0897269180754226,0.390586296397635
"S01006209",683,808,125,0.15470297029703,0.186248776754883
"S01006210",708,817,109,0.133414932680539,0.238842721750289
"S01006211",556,627,71,0.113237639553429,0.300657822315199
"S01006212",811,943,132,0.139978791092259,0.221356161279669
"S01006213",842,933,91,0.097534833869239,0.358347581321984
"S01006214",699,833,134,0.160864345738295,0.173109835383404
"S01006215",773,860,87,0.101162790697674,0.344199651877461
"S01006216",683,861,178,0.206736353077816,0.0986678175960482
"S01006217",891,1075,184,0.171162790697674,0.153000340682444
"S01006218",530,613,83,0.135399673735726,0.2334285384491
"S01006219",861,1010,149,0.147524752475248,0.202683211347898
"S01006220",779,930,151,0.162365591397849,0.170037648826587
"S01006221",787,871,84,0.0964408725602755,0.362715214982866
"S01006222",938,1041,103,0.0989433237271854,0.352793917343691
"S01006223",706,805,99,0.122981366459627,0.269208152026617
"S01006224",604,716,112,0.156424581005587,0.182490038637354
"S01006225",750,894,144,0.161073825503356,0.172678173377012
"S01006226",726,805,79,0.0981366459627329,0.355965086012678
"S01006227",674,771,97,0.125810635538262,0.260648472923318
"S01006228",749,852,103,0.120892018779343,0.275690771877567
"S01006229",885,1093,208,0.190301921317475,0.12112424625178
"S01006230",777,972,195,0.200617283950617,0.106548548746631
"S01006231",856,1040,184,0.176923076923077,0.142693520791177
"S01006232",563,795,232,0.291823899371069,0.0317258058326981
"S01006233",685,752,67,0.0890957446808511,0.393303045203203
"S01006234",472,632,160,0.253164556962025,0.0539820289184933
"S01006235",712,810,98,0.120987654320988,0.275391002868212
"S01006236",583,690,107,0.155072463768116,0.185436251735929
"S01006237",815,973,158,0.162384378211716,0.169999515922366
"S01006238",941,1072,131,0.122201492537313,0.271611641797907
"S01006239",476,555,79,0.142342342342342,0.215347431391988
"S01006240",829,968,139,0.143595041322314,0.212222649609529
"S01006241",728,971,243,0.250257466529351,0.0561204951378038
"S01006242",712,820,108,0.131707317073171,0.243591097723488
"S01006243",624,666,42,0.0630630630630631,0.521319061942851
"S01006244",589,652,63,0.0966257668711656,0.361973677911889
"S01006245",596,707,111,0.157001414427157,0.181246011988365
"S01006246",693,816,123,0.150735294117647,0.195177952870533
"S01006247",843,936,93,0.0993589743589744,0.351169879732979
"S01006248",799,873,74,0.0847651775486827,0.412406361775206
"S01006249",689,851,162,0.190364277320799,0.121030999062533
"S01006250",647,761,114,0.149802890932983,0.197331419043207
"S01006251",593,660,67,0.101515151515152,0.342852703391241
"S01006252",612,666,54,0.0810810810810811,0.429310914434837
"S01006253",669,770,101,0.131168831168831,0.245105990624334
"S01006254",589,763,174,0.228047182175623,0.0751462941784264
"S01006255",953,1066,113,0.106003752345216,0.326104625914899
"S01006256",648,723,75,0.103734439834025,0.334477636528829
"S01006257",763,863,100,0.115874855156431,0.291835031205529
"S01006258",664,848,184,0.216981132075472,0.086640763573356
"S01006259",657,760,103,0.135526315789474,0.233086850030413
"S01006260",893,1119,226,0.201966041108132,0.104764398439715
"S01006261",826,919,93,0.101196953210011,0.344068852731638
"S01006262",618,773,155,0.200517464424321,0.106681671514914
"S01006263",793,902,109,0.120842572062084,0.275845877448678
"S01006264",893,1041,148,0.142170989433237,0.215778064780191
"S01006265",764,929,165,0.177610333692142,0.141506518407867
"S01006266",651,872,221,0.253440366972477,0.0537830016067256
"S01006267",611,720,109,0.151388888888889,0.193681053228366
"S01006268",733,870,137,0.157471264367816,0.180238357162851
"S01006269",619,725,106,0.146206896551724,0.205838412837249
"S01006270",857,1032,175,0.169573643410853,0.155959288891155
"S01006271",671,799,128,0.160200250312891,0.174484723087967
"S01006272",800,990,190,0.191919191919192,0.118726570735001
"S01006273",636,732,96,0.131147540983607,0.24516605899655
"S01006274",571,641,70,0.109204368174727,0.314615987028987
"S01006275",547,858,311,0.362470862470862,0.0110917579815094
"S01006276",752,931,179,0.192266380236305,0.118217452423528
"S01006277",738,892,154,0.172645739910314,0.150284805802966
"S01006278",667,828,161,0.194444444444444,0.115068107741237
"S01006279",851,1059,208,0.196411709159585,0.112288686003287
"S01006280",724,843,119,0.141162514827995,0.218328240954092
"S01006281",725,863,138,0.159907300115875,0.175094340404697
"S01006282",677,764,87,0.113874345549738,0.298506024867499
"S01006283",684,774,90,0.116279069767442,0.290503527568264
"S01006284",772,864,92,0.106481481481481,0.324366189208856
"S01006285",739,871,132,0.151549942594719,0.193313789300827
"S01006286",814,1022,208,0.203522504892368,0.102738942433985
"S01006287",583,663,80,0.120663650075415,0.276407780419836
"S01006288",769,936,167,0.178418803418803,0.140121542860478
"S01006289",828,967,139,0.143743536711479,0.211854955489868
"S01006290",869,1018,149,0.146365422396857,0.20545654681005
"S01006291",493,600,107,0.178333333333333,0.140267381255924
"S01006292",861,944,83,0.0879237288135593,0.398392883083416
"S01006293",928,1025,97,0.0946341463414634,0.370033555149351
"S01006294",614,694,80,0.115273775216138,0.293825177284244
"S01006295",580,630,50,0.0793650793650794,0.437395631396735
"S01006296",872,1030,158,0.153398058252427,0.189144014396821
"S01006297",711,825,114,0.138181818181818,0.22602502283854
"S01006298",829,921,92,0.0998914223669924,0.349099320537217
"S01006299",740,834,94,0.112709832134293,0.302452160354804
"S01006300",733,849,116,0.136631330977621,0.230124492616803
"S01006301",573,660,87,0.131818181818182,0.243280256065888
"S01006302",881,992,111,0.111895161290323,0.305240644995319
"S01006303",630,749,119,0.158878504672897,0.177250438207473
"S01006304",648,772,124,0.160621761658031,0.17361092673322
"S01006305",627,726,99,0.136363636363636,0.230839009056934
"S01006306",702,786,84,0.106870229007634,0.322957712935692
"S01006307",743,888,145,0.163288288288288,0.168173855123382
"S01006308",602,709,107,0.150916784203103,0.19476125336927
"S01006309",840,1046,206,0.196940726577438,0.111551654324257
"S01006310",700,836,136,0.162679425837321,0.169401645957892
"S01006311",751,835,84,0.10059880239521,0.346365490381292
"S01006312",625,705,80,0.113475177304965,0.299853417892373
"S01006313",928,1083,155,0.143120960295476,0.213400383686414
"S01006314",630,728,98,0.134615384615385,0.235554660573633
"S01006315",823,940,117,0.124468085106383,0.264679201717981
"S01006316",882,984,102,0.103658536585366,0.334761008085343
"S01006317",813,959,146,0.152241918665276,0.191742940926266
"S01006318",725,832,107,0.128605769230769,0.252433391863828
"S01006319",846,957,111,0.115987460815047,0.291463551581026
"S01006320",829,1013,184,0.181638696939783,0.134725825062292
"S01006321",650,725,75,0.103448275862069,0.335547108486829
"S01006322",621,733,112,0.152796725784447,0.190491786747395
"S01006323",719,946,227,0.239957716701903,0.0643246659936915
"S01006324",546,681,135,0.198237885462555,0.109762833047365
"S01006325",610,717,107,0.149232914923291,0.198658336005439
"S01006326",854,1030,176,0.170873786407767,0.153534669986925
"S01006327",498,621,123,0.198067632850242,0.109996135119059
"S01006328",621,780,159,0.203846153846154,0.102322224891753
"S01006329",908,1019,111,0.108930323846909,0.315585212528495
"S01006330",686,850,164,0.192941176470588,0.117233545594504
"S01006331",704,780,76,0.0974358974358974,0.358740628371443
"S01006332",602,698,96,0.137535816618911,0.227724987205442
"S01006333",814,976,162,0.165983606557377,0.162834292760237
"S01006334",764,855,91,0.106432748538012,0.324543143564301
"S01006335",835,935,100,0.106951871657754,0.322662612706635
"S01006336",625,816,191,0.23406862745098,0.0694862038218307
"S01006337",309,728,419,0.575549450549451,0.00018978898409975
"S01006338",815,942,127,0.134819532908705,0.234999565598901
"S01006339",731,874,143,0.163615560640732,0.167517214635005
"S01006340",690,801,111,0.138576779026217,0.224991311119389
"S01006341",710,847,137,0.161747343565525,0.171296852817114
"S01006342",707,854,147,0.172131147540984,0.15122215791452
"S01006343",681,798,117,0.146616541353383,0.204852942074019
"S01006344",751,821,70,0.0852618757612667,0.410173689164114
"S01006345",529,625,96,0.1536,0.188693329162797
"S01006346",584,663,79,0.119155354449472,0.281185671951002
"S01006347",589,675,86,0.127407407407407,0.255926477706738
"S01006348",616,715,99,0.138461538461538,0.225292484103636
"S01006349",457,534,77,0.144194756554307,0.210741191137637
"S01006350",640,792,152,0.191919191919192,0.118726570735001
"S01006351",859,1214,355,0.292421746293245,0.0314589896783272
"S01006352",715,821,106,0.12911084043849,0.250974066078673
"S01006353",516,604,88,0.145695364238411,0.207074980941913
"S01006354",904,1024,120,0.1171875,0.287531042093916
"S01006355",628,804,176,0.218905472636816,0.0845348818273829
"S01006356",669,832,163,0.195913461538462,0.112986853592205
"S01006357",689,797,108,0.135508155583438,0.233135819773136
"S01006358",633,774,141,0.182170542635659,0.13385281015139
"S01006359",829,988,159,0.160931174089069,0.172972020958792
"S01006360",605,748,143,0.191176470588235,0.119822332066174
"S01006361",740,912,172,0.18859649122807,0.123699747754005
"S01006362",729,844,115,0.136255924170616,0.231127071675539
"S01006363",677,764,87,0.113874345549738,0.298506024867499
"S01006364",528,666,138,0.207207207207207,0.0980837210740517
"S01006365",876,1066,190,0.178236397748593,0.140432948654842
"S01006366",697,778,81,0.104113110539846,0.333067157827187
"S01006367",724,863,139,0.161066048667439,0.172694181291433
"S01006368",843,900,57,0.0633333333333333,0.519817207510204
"S01006369",752,876,124,0.141552511415525,0.217338839729576
"S01006370",908,1033,125,0.121006776379477,0.275331100098805
"S01006371",465,570,105,0.184210526315789,0.130551231278288
"S01006372",718,818,100,0.122249388753056,0.271463475950036
"S01006373",651,956,305,0.319037656903766,0.0214403051866621
"S01006374",645,743,98,0.131897711978466,0.243057490010026
"S01006375",581,752,171,0.227393617021277,0.0757849411998987
"S01006376",599,751,152,0.202396804260985,0.104200272293297
"S01006377",551,655,104,0.158778625954198,0.177461026210061
"S01006378",448,580,132,0.227586206896552,0.0755962416047899
"S01006379",697,763,66,0.0865006553079948,0.404652661715967
"S01006380",567,626,59,0.0942492012779553,0.371609884066786
"S01006381",478,571,93,0.162872154115587,0.169012133353421
"S01006382",664,758,94,0.12401055408971,0.266065605961085
"S01006383",581,667,86,0.128935532233883,0.251479729616432
"S01006384",718,817,99,0.121175030599755,0.274804523387068
"S01006385",855,1064,209,0.196428571428571,0.112265125888392
"S01006386",850,1005,155,0.154228855721393,0.187296059145312
"S01006387",720,875,155,0.177142857142857,0.142312954217118
"S01006388",874,1127,253,0.224489795918367,0.0786819592837673
"S01006389",637,774,137,0.177002583979328,0.14255574252115
"S01006390",623,708,85,0.120056497175141,0.278322226311676
"S01006391",772,1073,301,0.280521901211556,0.0371685640991088
"S01006392",761,937,176,0.187833511205977,0.12486785713527
"S01006393",698,895,197,0.220111731843575,0.083238428637737
"S01006394",744,904,160,0.176991150442478,0.142575548394219
"S01006395",842,1017,175,0.172074729596853,0.15132524501687
"S01006396",535,651,116,0.178187403993856,0.140516697602248
"S01006397",679,839,160,0.190703218116806,0.120525275955001
"S01006398",810,944,134,0.141949152542373,0.216336722471628
"S01006399",699,859,160,0.186263096623981,0.127303434080212
"S01006400",794,1014,220,0.216962524654832,0.0866613548210048
"S01006401",696,878,182,0.207289293849658,0.0979822114105044
"S01006402",604,740,136,0.183783783783784,0.131235759475126
"S01006403",715,826,111,0.134382566585956,0.236189150862563
"S01006404",698,830,132,0.159036144578313,0.176918521963294
"S01006405",702,920,218,0.23695652173913,0.0669102800868274
"S01006406",687,824,137,0.16626213592233,0.162291305430813
"S01006407",617,781,164,0.209987195902689,0.0946981078605456
"S01006408",868,1103,235,0.213055303717135,0.0910840068662943
"S01006409",461,652,191,0.292944785276074,0.031227218105139
"S01006410",670,769,99,0.128738621586476,0.252048797030521
"S01006411",672,906,234,0.258278145695364,0.0503977042670957
"S01006412",664,770,106,0.137662337662338,0.2273911415674
"S01006413",601,722,121,0.167590027700831,0.159724943923364
"S01006414",493,564,71,0.125886524822695,0.260422289656005
"S01006415",763,897,134,0.149386845039019,0.198299194053525
"S01006416",533,659,126,0.191198786039454,0.11978927717402
"S01006417",637,750,113,0.150666666666667,0.195335729793335
"S01006418",621,758,137,0.180738786279683,0.136214689713931
"S01006419",536,622,86,0.138263665594855,0.225810457171734
"S01006420",845,1029,184,0.178814382896016,0.139448337785413
"S01006421",525,617,92,0.149108589951378,0.19894883196232
"S01006422",599,746,147,0.197050938337802,0.111398655477604
"S01006423",445,651,206,0.316436251920123,0.0222735901529924
"S01006424",600,695,95,0.136690647482014,0.229966437760657
"S01006425",657,798,141,0.176691729323308,0.143095106459738
"S01006426",442,563,121,0.214920071047957,0.0889485238203196
"S01006427",693,827,134,0.162031438935913,0.170717188792409
"S01006428",784,881,97,0.110102156640182,0.311459471782112
"S01006429",511,637,126,0.197802197802198,0.110360758832281
"S01006430",585,657,72,0.10958904109589,0.313260015601627
"S01006431",540,612,72,0.117647058823529,0.286037765539156
"S01006432",660,791,131,0.165613147914033,0.163559027804518
"S01006433",609,732,123,0.168032786885246,0.158877396958593
"S01006434",763,863,100,0.115874855156431,0.291835031205529
"S01006435",441,549,108,0.19672131147541,0.111856815275009
"S01006436",689,811,122,0.150431565967941,0.195877105136429
"S01006437",888,1032,144,0.13953488372093,0.222501367685551
"S01006438",554,639,85,0.13302034428795,0.2399324925371
"S01006439",655,810,155,0.191358024691358,0.119553642118191
"S01006440",765,880,115,0.130681818181818,0.246483373899639
"S01006441",635,764,129,0.168848167539267,0.157327147002314
"S01006442",753,824,71,0.0861650485436893,0.406141758645967
"S01006443",472,569,97,0.170474516695958,0.15427562780291
"S01006444",514,603,89,0.14759535655058,0.202515406728419
"S01006445",709,849,140,0.16489988221437,0.164962583445805
"S01006446",803,968,165,0.170454545454545,0.154312774457152
"S01006447",546,630,84,0.133333333333333,0.2390677160551
"S01006448",816,946,130,0.137420718816068,0.228029073939754
"S01006449",468,556,88,0.158273381294964,0.178529757436437
"S01006450",610,771,161,0.208819714656291,0.0961069001360451
"S01006451",660,782,122,0.156010230179028,0.183388384529189
"S01006452",537,600,63,0.105,0.329784586096516
"S01006453",719,856,137,0.160046728971963,0.174803956040361
"S01006454",525,605,80,0.132231404958678,0.242124806993232
"S01006455",602,724,122,0.168508287292818,0.157971685016872
"S01006456",801,946,145,0.153276955602537,0.189414750742382
"S01006457",610,693,83,0.11976911976912,0.279232525307238
"S01006458",817,984,167,0.169715447154472,0.155693177098301
"S01006459",555,728,173,0.237637362637363,0.0663156511192327
"S01006460",483,562,79,0.140569395017794,0.21984072713013
"S01006461",609,809,200,0.247218788627936,0.0584369728053912
"S01006462",668,779,111,0.142490372272144,0.214976034751149
"S01006463",619,743,124,0.166890982503365,0.161071369994429
"S01006464",684,822,138,0.167883211678832,0.159163265851411
"S01006465",829,1024,195,0.1904296875,0.120933254093931
"S01006466",725,773,48,0.0620957309184994,0.526726448991639
"S01006467",863,1010,147,0.145544554455446,0.207440819437943
"S01006468",877,1104,227,0.205615942028986,0.100070299533094
"S01006469",635,710,75,0.105633802816901,0.327456613211412
"S01006470",745,882,137,0.155328798185941,0.184874441988721
"S01006471",665,865,200,0.23121387283237,0.0721199435940159
"S01006472",517,623,106,0.170144462279294,0.154890565137677
"S01006473",782,878,96,0.109339407744875,0.314139372244988
"S01006474",790,878,88,0.100227790432802,0.347796937746285
"S01006475",788,917,129,0.140676117775354,0.219567884829808
"S01006476",675,831,156,0.187725631768953,0.125033817304947
"S01006477",677,852,175,0.205399061032864,0.100343845178294
"S01006478",753,922,169,0.183297180043384,0.132020250198536
"S01006479",668,768,100,0.130208333333333,0.247829171166007
"S01006480",775,953,178,0.186778593913956,0.126499269819568
"S01006481",536,662,126,0.190332326283988,0.121078770580088
"S01006482",692,846,154,0.182033096926714,0.134077935500702
"S01006483",853,962,109,0.113305613305613,0.300427435989315
"S01006484",700,831,131,0.157641395908544,0.179874733003492
"S01006485",610,724,114,0.157458563535912,0.180265529320606
"S01006486",793,931,138,0.148227712137487,0.201018053525397
"S01006487",690,821,131,0.159561510353228,0.175816380949203
"S01006488",597,688,91,0.132267441860465,0.242024275612656
"S01006489",737,815,78,0.0957055214723926,0.365677964792921
"S01006490",739,814,75,0.0921375921375921,0.380364813778191
"S01006491",770,904,134,0.148230088495575,0.201012445396474
"S01006492",554,624,70,0.112179487179487,0.304264826735471
"S01006493",500,653,153,0.234303215926493,0.0692736754532363
"S01006494",530,644,114,0.177018633540373,0.142527944665706
"S01006495",736,831,95,0.114320096269555,0.297007834640708
"S01006496",816,992,176,0.17741935483871,0.141835474526365
"S01006497",503,622,119,0.191318327974277,0.119612344681159
"S01006498",972,1184,212,0.179054054054054,0.139041878113551
"S01006499",791,884,93,0.105203619909502,0.329035066529704
"S01006500",703,776,73,0.0940721649484536,0.372336864877949
"S01006501",897,1044,147,0.140804597701149,0.219239823504492
"S01006502",589,684,95,0.138888888888889,0.22417745303365
"S01006503",667,737,70,0.0949796472184532,0.36862387536723
"S01006504",706,868,162,0.186635944700461,0.12672134060901
"S01006505",665,820,155,0.189024390243902,0.123048954832582
